ID,Флаг дозвона,Флаг продажи,Расходы,PV,NPV
0,1,1,450,1745,1295
1,1,0,63,0,-63
2,1,1,459,1484,1025
3,0,0,72,0,-72
4,0,0,142,0,-142
5,1,1,129,1232,1103
6,1,1,2387,1470,-917
7,0,0,11,0,-11
8,1,0,77,0,-77
9,1,1,140,1635,1495
10,1,0,28,0,-28
11,1,0,28,0,-28
12,0,0,26,0,-26
13,1,0,21,0,-21
14,1,0,79,0,-79
15,1,0,276,0,-276
16,0,0,154,0,-154
17,0,0,26,0,-26
18,1,1,94,1409,1315
19,1,0,44,0,-44
20,1,1,495,1248,753
21,0,0,12,0,-12
22,1,0,4,0,-4
23,0,0,61,0,-61
24,0,0,30,0,-30
25,0,0,46,0,-46
26,1,1,865,1283,418
27,1,1,706,1503,797
28,1,1,150,1429,1279
29,1,0,92,0,-92
30,1,0,12,0,-12
31,1,0,4,0,-4
32,0,0,59,0,-59
33,1,0,138,0,-138
34,1,0,40,0,-40
35,0,0,74,0,-74
36,1,0,5,0,-5
37,1,1,171,1282,1111
38,1,0,101,0,-101
39,1,1,554,1439,885
40,1,1,430,1386,956
41,1,0,168,0,-168
42,1,0,4,0,-4
43,1,1,244,1431,1187
44,0,0,3,0,-3
45,0,0,13,0,-13
46,1,0,53,0,-53
47,1,0,13,0,-13
48,0,0,20,0,-20
49,1,1,2653,1348,-1305
50,1,0,139,0,-139
51,1,0,174,0,-174
52,1,0,22,0,-22
53,1,1,142,1240,1098
54,0,0,102,0,-102
55,0,0,228,0,-228
56,1,0,58,0,-58
57,1,0,3,0,-3
58,1,0,191,0,-191
59,0,0,57,0,-57
60,0,0,59,0,-59
61,1,0,26,0,-26
62,1,1,74,1320,1246
63,0,0,178,0,-178
64,0,0,49,0,-49
65,1,0,1,0,-1
66,1,0,39,0,-39
67,0,0,27,0,-27
68,1,0,29,0,-29
69,1,0,13,0,-13
70,1,0,43,0,-43
71,0,0,21,0,-21
72,1,1,322,1460,1138
73,0,0,220,0,-220
74,1,0,33,0,-33
75,1,0,116,0,-116
76,0,0,12,0,-12
77,0,0,57,0,-57
78,1,1,637,2520,1883
79,0,0,71,0,-71
80,0,0,12,0,-12
81,1,1,777,1288,511
82,1,0,38,0,-38
83,1,0,82,0,-82
84,1,1,218,1930,1712
85,0,0,124,0,-124
86,0,0,64,0,-64
87,1,1,190,1731,1541
88,1,0,10,0,-10
89,1,1,320,1601,1281
90,1,0,14,0,-14
91,1,1,85,1212,1127
92,1,1,118,1349,1231
93,0,0,39,0,-39
94,1,0,10,0,-10
95,0,0,110,0,-110
96,1,0,119,0,-119
97,0,0,32,0,-32
98,0,0,27,0,-27
99,1,1,377,1276,899
100,0,0,28,0,-28
101,1,1,249,2062,1813
102,0,0,202,0,-202
103,0,0,17,0,-17
104,0,0,21,0,-21
105,0,0,150,0,-150
106,1,1,84,1343,1259
107,1,0,6,0,-6
108,0,0,8,0,-8
109,0,0,15,0,-15
110,1,1,280,1269,989
111,0,0,101,0,-101
112,1,1,143,1349,1206
113,1,1,588,1386,798
114,1,1,596,1343,747
115,1,1,668,2063,1395
116,0,0,23,0,-23
117,0,0,97,0,-97
118,0,0,34,0,-34
119,0,0,44,0,-44
120,1,0,53,0,-53
121,0,0,25,0,-25
122,1,1,190,1347,1157
123,0,0,6,0,-6
124,1,0,16,0,-16
125,0,0,33,0,-33
126,1,1,9,1204,1195
127,1,0,105,0,-105
128,1,1,405,1464,1059
129,1,0,4,0,-4
130,0,0,75,0,-75
131,1,1,55,2196,2141
132,0,0,42,0,-42
133,1,0,81,0,-81
134,0,0,58,0,-58
135,1,0,1,0,-1
136,1,0,36,0,-36
137,1,0,32,0,-32
138,0,0,13,0,-13
139,1,1,1869,1505,-364
140,1,0,57,0,-57
141,1,1,644,1761,1117
142,0,0,121,0,-121
143,0,0,66,0,-66
144,1,1,937,1332,395
145,1,1,438,1527,1089
146,1,0,78,0,-78
147,0,0,15,0,-15
148,0,0,99,0,-99
149,1,0,26,0,-26
150,1,1,275,2083,1808
151,0,0,48,0,-48
152,1,1,155,1331,1176
153,1,0,123,0,-123
154,0,0,129,0,-129
155,0,0,42,0,-42
156,1,0,35,0,-35
157,1,1,992,1413,421
158,0,0,59,0,-59
159,0,0,3,0,-3
160,0,0,115,0,-115
161,0,0,7,0,-7
162,0,0,26,0,-26
163,1,1,932,2373,1441
164,0,0,1,0,-1
165,1,1,620,1336,716
166,0,0,12,0,-12
167,1,1,712,1269,557
168,1,1,702,1243,541
169,0,0,7,0,-7
170,0,0,10,0,-10
171,1,1,437,2269,1832
172,1,1,210,1260,1050
173,1,0,0,0,0
174,1,0,16,0,-16
175,1,0,51,0,-51
176,1,0,105,0,-105
177,0,0,57,0,-57
178,1,1,49,1367,1318
179,1,1,1275,1378,103
180,0,0,93,0,-93
181,1,0,16,0,-16
182,0,0,2,0,-2
183,1,1,541,1216,675
184,1,0,149,0,-149
185,0,0,12,0,-12
186,1,0,12,0,-12
187,0,0,8,0,-8
188,0,0,35,0,-35
189,1,1,836,1418,582
190,1,0,110,0,-110
191,0,0,42,0,-42
192,0,0,104,0,-104
193,0,0,8,0,-8
194,1,0,1,0,-1
195,1,0,9,0,-9
196,0,0,5,0,-5
197,0,0,62,0,-62
198,1,0,23,0,-23
199,1,1,1155,1283,128
200,1,1,735,1223,488
201,1,1,131,1770,1639
202,1,0,108,0,-108
203,1,1,281,2611,2330
204,0,0,14,0,-14
205,1,0,52,0,-52
206,1,1,328,1707,1379
207,1,1,879,1207,328
208,0,0,90,0,-90
209,0,0,18,0,-18
210,0,0,5,0,-5
211,1,0,61,0,-61
212,1,0,77,0,-77
213,0,0,34,0,-34
214,1,0,32,0,-32
215,0,0,8,0,-8
216,1,0,48,0,-48
217,1,1,891,1788,897
218,1,0,48,0,-48
219,0,0,17,0,-17
220,1,1,188,1287,1099
221,1,0,20,0,-20
222,0,0,15,0,-15
223,1,1,1021,2037,1016
224,0,0,88,0,-88
225,1,0,27,0,-27
226,0,0,28,0,-28
227,1,1,94,1270,1176
228,0,0,32,0,-32
229,1,1,56,1712,1656
230,0,0,5,0,-5
231,1,0,31,0,-31
232,1,0,74,0,-74
233,0,0,57,0,-57
234,0,0,209,0,-209
235,1,1,938,1205,267
236,0,0,3,0,-3
237,0,0,14,0,-14
238,0,0,61,0,-61
239,0,0,8,0,-8
240,1,0,28,0,-28
241,1,0,15,0,-15
242,0,0,16,0,-16
243,1,1,205,1332,1127
244,1,1,140,1261,1121
245,0,0,246,0,-246
246,0,0,81,0,-81
247,0,0,68,0,-68
248,0,0,13,0,-13
249,0,0,28,0,-28
250,1,1,310,1841,1531
251,1,1,71,1401,1330
252,1,0,113,0,-113
253,0,0,56,0,-56
254,0,0,21,0,-21
255,1,1,534,1347,813
256,1,0,157,0,-157
257,1,0,13,0,-13
258,1,0,33,0,-33
259,1,0,32,0,-32
260,1,0,3,0,-3
261,1,1,147,1454,1307
262,1,1,278,2182,1904
263,0,0,1,0,-1
264,1,0,130,0,-130
265,1,0,27,0,-27
266,1,1,676,2876,2200
267,0,0,23,0,-23
268,1,0,45,0,-45
269,1,0,4,0,-4
270,0,0,84,0,-84
271,1,0,29,0,-29
272,0,0,57,0,-57
273,1,1,770,2009,1239
274,1,1,449,1478,1029
275,1,0,7,0,-7
276,1,1,1582,1219,-363
277,1,1,186,1729,1543
278,1,1,648,2160,1512
279,0,0,26,0,-26
280,0,0,123,0,-123
281,1,0,28,0,-28
282,1,0,5,0,-5
283,1,1,527,1241,714
284,1,0,127,0,-127
285,1,1,1072,1703,631
286,1,0,31,0,-31
287,0,0,43,0,-43
288,1,1,13,2973,2960
289,0,0,12,0,-12
290,1,0,79,0,-79
291,1,1,233,1598,1365
292,1,1,415,1296,881
293,1,1,411,1285,874
294,0,0,23,0,-23
295,1,1,1313,1225,-88
296,0,0,55,0,-55
297,0,0,11,0,-11
298,0,0,123,0,-123
299,0,0,63,0,-63
300,1,0,65,0,-65
301,0,0,95,0,-95
302,0,0,37,0,-37
303,1,1,80,3500,3420
304,1,0,87,0,-87
305,1,0,7,0,-7
306,0,0,1,0,-1
307,0,0,148,0,-148
308,0,0,7,0,-7
309,0,0,17,0,-17
310,1,1,734,1489,755
311,1,1,115,1856,1741
312,0,0,39,0,-39
313,1,1,598,2063,1465
314,0,0,1,0,-1
315,1,0,5,0,-5
316,1,1,591,2749,2158
317,1,0,27,0,-27
318,1,1,302,1373,1071
319,1,1,220,1639,1419
320,1,1,135,1224,1089
321,0,0,179,0,-179
322,0,0,25,0,-25
323,0,0,67,0,-67
324,0,0,25,0,-25
325,1,1,438,1227,789
326,1,0,16,0,-16
327,0,0,94,0,-94
328,1,0,28,0,-28
329,0,0,7,0,-7
330,1,1,767,1281,514
331,0,0,97,0,-97
332,1,1,353,1360,1007
333,1,1,394,1609,1215
334,1,1,36,1917,1881
335,1,1,783,1434,651
336,0,0,56,0,-56
337,0,0,14,0,-14
338,1,1,1195,1210,15
339,0,0,49,0,-49
340,1,1,883,1358,475
341,1,0,120,0,-120
342,0,0,34,0,-34
343,1,0,39,0,-39
344,0,0,5,0,-5
345,0,0,10,0,-10
346,1,0,1,0,-1
347,0,0,51,0,-51
348,1,0,23,0,-23
349,0,0,72,0,-72
350,0,0,3,0,-3
351,1,1,44,1606,1562
352,1,0,172,0,-172
353,1,0,44,0,-44
354,0,0,225,0,-225
355,1,1,610,1423,813
356,0,0,12,0,-12
357,1,1,220,1500,1280
358,0,0,34,0,-34
359,1,1,538,1391,853
360,0,0,53,0,-53
361,0,0,231,0,-231
362,1,1,479,1292,813
363,1,1,867,1688,821
364,1,0,47,0,-47
365,0,0,7,0,-7
366,0,0,21,0,-21
367,1,1,19,4690,4671
368,1,0,16,0,-16
369,1,0,224,0,-224
370,0,0,239,0,-239
371,1,0,48,0,-48
372,1,1,1480,1286,-194
373,0,0,0,0,0
374,1,1,1343,2356,1013
375,0,0,5,0,-5
376,0,0,30,0,-30
377,0,0,215,0,-215
378,0,0,10,0,-10
379,1,1,233,1315,1082
380,0,0,105,0,-105
381,0,0,14,0,-14
382,0,0,5,0,-5
383,0,0,39,0,-39
384,1,1,352,1393,1041
385,0,0,62,0,-62
386,1,0,5,0,-5
387,1,0,24,0,-24
388,0,0,55,0,-55
389,1,0,41,0,-41
390,1,0,13,0,-13
391,0,0,29,0,-29
392,1,0,2,0,-2
393,0,0,60,0,-60
394,1,1,502,1242,740
395,0,0,105,0,-105
396,1,0,88,0,-88
397,0,0,63,0,-63
398,1,1,308,1651,1343
399,0,0,3,0,-3
400,0,0,122,0,-122
401,0,0,13,0,-13
402,1,1,17,1680,1663
403,1,1,118,1395,1277
404,0,0,48,0,-48
405,0,0,29,0,-29
406,1,1,772,1409,637
407,1,0,174,0,-174
408,1,0,162,0,-162
409,1,1,452,1626,1174
410,1,0,55,0,-55
411,1,0,93,0,-93
412,0,0,27,0,-27
413,1,1,442,1745,1303
414,0,0,36,0,-36
415,0,0,81,0,-81
416,1,0,13,0,-13
417,0,0,4,0,-4
418,1,1,321,1223,902
419,1,0,14,0,-14
420,1,0,31,0,-31
421,0,0,17,0,-17
422,1,1,42,1494,1452
423,0,0,26,0,-26
424,0,0,112,0,-112
425,0,0,22,0,-22
426,1,0,26,0,-26
427,0,0,34,0,-34
428,1,1,367,1230,863
429,0,0,97,0,-97
430,1,1,221,1207,986
431,0,0,151,0,-151
432,0,0,8,0,-8
433,1,0,55,0,-55
434,1,0,4,0,-4
435,0,0,91,0,-91
436,0,0,3,0,-3
437,1,0,15,0,-15
438,1,0,30,0,-30
439,0,0,51,0,-51
440,1,1,65,2319,2254
441,1,0,174,0,-174
442,1,0,7,0,-7
443,1,0,125,0,-125
444,0,0,62,0,-62
445,0,0,22,0,-22
446,1,0,39,0,-39
447,0,0,76,0,-76
448,1,0,1,0,-1
449,1,0,10,0,-10
450,1,1,74,1284,1210
451,0,0,0,0,0
452,0,0,20,0,-20
453,0,0,29,0,-29
454,1,1,668,1536,868
455,0,0,112,0,-112
456,1,1,644,1259,615
457,1,1,926,1318,392
458,0,0,56,0,-56
459,1,0,45,0,-45
460,0,0,2,0,-2
461,1,0,17,0,-17
462,0,0,51,0,-51
463,0,0,6,0,-6
464,1,1,273,1772,1499
465,1,1,388,1442,1054
466,1,0,43,0,-43
467,0,0,170,0,-170
468,1,0,32,0,-32
469,1,1,114,2237,2123
470,1,0,10,0,-10
471,1,0,7,0,-7
472,1,1,1019,1484,465
473,1,1,98,1465,1367
474,1,0,69,0,-69
475,1,1,477,1435,958
476,1,1,252,2231,1979
477,1,1,344,1489,1145
478,0,0,11,0,-11
479,1,1,724,1976,1252
480,0,0,17,0,-17
481,1,0,71,0,-71
482,0,0,18,0,-18
483,1,0,8,0,-8
484,0,0,164,0,-164
485,0,0,5,0,-5
486,1,1,1164,1316,152
487,0,0,21,0,-21
488,1,1,147,1220,1073
489,0,0,3,0,-3
490,1,0,29,0,-29
491,0,0,20,0,-20
492,1,0,54,0,-54
493,0,0,221,0,-221
494,1,0,89,0,-89
495,1,0,55,0,-55
496,0,0,4,0,-4
497,1,0,26,0,-26
498,1,1,501,1482,981
499,0,0,1,0,-1
500,1,1,1768,1397,-371
501,1,0,157,0,-157
502,1,0,58,0,-58
503,1,1,94,1203,1109
504,1,1,147,1226,1079
505,0,0,142,0,-142
506,0,0,71,0,-71
507,1,0,135,0,-135
508,1,1,576,1426,850
509,0,0,27,0,-27
510,0,0,15,0,-15
511,1,0,3,0,-3
512,0,0,15,0,-15
513,0,0,1,0,-1
514,0,0,47,0,-47
515,0,0,28,0,-28
516,1,0,18,0,-18
517,1,1,413,1237,824
518,0,0,26,0,-26
519,0,0,12,0,-12
520,1,1,1586,1760,174
521,1,1,665,1326,661
522,0,0,30,0,-30
523,0,0,17,0,-17
524,1,0,203,0,-203
525,0,0,116,0,-116
526,1,1,470,1685,1215
527,0,0,24,0,-24
528,1,0,71,0,-71
529,0,0,72,0,-72
530,0,0,110,0,-110
531,1,1,579,1740,1161
532,1,0,17,0,-17
533,1,0,0,0,0
534,0,0,69,0,-69
535,0,0,108,0,-108
536,1,0,4,0,-4
537,1,0,16,0,-16
538,1,1,830,1873,1043
539,0,0,78,0,-78
540,0,0,125,0,-125
541,1,1,317,1779,1462
542,0,0,9,0,-9
543,1,0,47,0,-47
544,1,0,8,0,-8
545,0,0,26,0,-26
546,1,1,1137,1398,261
547,1,1,60,1978,1918
548,0,0,195,0,-195
549,0,0,25,0,-25
550,0,0,66,0,-66
551,1,0,60,0,-60
552,1,1,659,1441,782
553,1,1,260,1486,1226
554,0,0,107,0,-107
555,1,1,107,2075,1968
556,1,1,299,3074,2775
557,1,0,39,0,-39
558,1,0,16,0,-16
559,1,1,338,1526,1188
560,1,1,819,1209,390
561,1,1,244,1895,1651
562,1,1,182,1360,1178
563,0,0,5,0,-5
564,0,0,11,0,-11
565,0,0,29,0,-29
566,1,0,3,0,-3
567,1,1,142,2663,2521
568,1,0,247,0,-247
569,0,0,45,0,-45
570,0,0,36,0,-36
571,1,1,1272,1384,112
572,0,0,35,0,-35
573,0,0,17,0,-17
574,1,0,11,0,-11
575,1,0,49,0,-49
576,1,1,536,1359,823
577,1,1,604,1382,778
578,0,0,48,0,-48
579,1,1,2275,1438,-837
580,0,0,15,0,-15
581,0,0,55,0,-55
582,1,1,1370,1211,-159
583,1,0,41,0,-41
584,1,0,21,0,-21
585,1,0,81,0,-81
586,0,0,12,0,-12
587,1,1,1233,1482,249
588,1,1,1102,1319,217
589,1,1,1896,1273,-623
590,1,1,734,1218,484
591,1,1,874,3649,2775
592,1,0,19,0,-19
593,0,0,161,0,-161
594,1,1,640,1342,702
595,1,1,814,1225,411
596,0,0,26,0,-26
597,1,1,388,1400,1012
598,0,0,10,0,-10
599,0,0,179,0,-179
600,0,0,8,0,-8
601,1,1,419,1365,946
602,1,0,46,0,-46
603,1,1,360,2149,1789
604,1,1,68,1214,1146
605,1,1,737,1283,546
606,0,0,1,0,-1
607,0,0,4,0,-4
608,1,1,473,1924,1451
609,0,0,43,0,-43
610,1,1,3050,1359,-1691
611,1,1,188,1227,1039
612,1,1,179,1514,1335
613,0,0,31,0,-31
614,1,1,53,1219,1166
615,0,0,8,0,-8
616,1,1,121,1680,1559
617,1,0,124,0,-124
618,1,0,16,0,-16
619,1,0,123,0,-123
620,1,0,18,0,-18
621,0,0,3,0,-3
622,1,1,835,1323,488
623,1,0,24,0,-24
624,1,0,3,0,-3
625,1,0,8,0,-8
626,1,0,7,0,-7
627,0,0,17,0,-17
628,0,0,21,0,-21
629,1,0,11,0,-11
630,1,0,25,0,-25
631,0,0,23,0,-23
632,1,0,38,0,-38
633,0,0,48,0,-48
634,1,1,90,1534,1444
635,0,0,32,0,-32
636,1,1,201,1337,1136
637,1,0,4,0,-4
638,1,1,472,1452,980
639,1,1,339,1724,1385
640,0,0,12,0,-12
641,1,0,24,0,-24
642,1,1,85,1486,1401
643,1,1,2009,1707,-302
644,1,0,40,0,-40
645,0,0,35,0,-35
646,1,0,63,0,-63
647,0,0,62,0,-62
648,0,0,52,0,-52
649,1,1,669,1288,619
650,1,0,2,0,-2
651,1,0,2,0,-2
652,1,1,1045,1569,524
653,1,0,83,0,-83
654,0,0,153,0,-153
655,0,0,55,0,-55
656,0,0,27,0,-27
657,1,1,79,1203,1124
658,1,0,2,0,-2
659,0,0,133,0,-133
660,1,0,36,0,-36
661,1,1,392,1200,808
662,1,1,356,1649,1293
663,0,0,74,0,-74
664,0,0,203,0,-203
665,0,0,6,0,-6
666,1,1,654,2164,1510
667,0,0,43,0,-43
668,0,0,13,0,-13
669,1,0,14,0,-14
670,0,0,30,0,-30
671,1,0,16,0,-16
672,1,0,33,0,-33
673,1,0,40,0,-40
674,0,0,37,0,-37
675,0,0,53,0,-53
676,1,1,643,1245,602
677,1,1,104,1246,1142
678,0,0,33,0,-33
679,1,0,56,0,-56
680,1,1,371,1714,1343
681,0,0,20,0,-20
682,1,0,90,0,-90
683,0,0,14,0,-14
684,1,0,28,0,-28
685,1,1,724,1262,538
686,1,1,596,1953,1357
687,1,0,26,0,-26
688,1,1,981,1363,382
689,1,1,806,1417,611
690,0,0,27,0,-27
691,0,0,77,0,-77
692,1,0,128,0,-128
693,0,0,13,0,-13
694,0,0,166,0,-166
695,0,0,20,0,-20
696,1,1,428,1456,1028
697,0,0,106,0,-106
698,1,1,85,2172,2087
699,1,1,132,1560,1428
700,1,1,280,1211,931
701,0,0,21,0,-21
702,1,1,341,3251,2910
703,1,1,426,1241,815
704,0,0,76,0,-76
705,1,0,113,0,-113
706,1,1,1172,2238,1066
707,0,0,4,0,-4
708,1,0,94,0,-94
709,0,0,127,0,-127
710,0,0,85,0,-85
711,0,0,131,0,-131
712,1,1,2175,1889,-286
713,1,1,65,1234,1169
714,1,0,4,0,-4
715,1,1,120,2398,2278
716,0,0,6,0,-6
717,0,0,25,0,-25
718,1,1,990,2605,1615
719,1,1,316,1252,936
720,1,1,77,1293,1216
721,1,0,12,0,-12
722,1,0,48,0,-48
723,0,0,11,0,-11
724,1,0,42,0,-42
725,0,0,21,0,-21
726,1,1,1167,1317,150
727,1,1,221,1305,1084
728,0,0,27,0,-27
729,0,0,39,0,-39
730,1,0,34,0,-34
731,1,1,243,1628,1385
732,1,1,460,1442,982
733,1,0,26,0,-26
734,1,0,13,0,-13
735,1,1,618,1269,651
736,0,0,6,0,-6
737,0,0,43,0,-43
738,0,0,96,0,-96
739,0,0,37,0,-37
740,0,0,48,0,-48
741,0,0,112,0,-112
742,0,0,96,0,-96
743,0,0,19,0,-19
744,1,0,3,0,-3
745,1,1,551,1292,741
746,0,0,128,0,-128
747,1,0,3,0,-3
748,0,0,22,0,-22
749,1,0,20,0,-20
750,0,0,37,0,-37
751,1,1,524,1658,1134
752,1,0,76,0,-76
753,0,0,49,0,-49
754,1,1,53,2163,2110
755,0,0,19,0,-19
756,1,1,96,1601,1505
757,1,1,804,1315,511
758,0,0,14,0,-14
759,1,0,80,0,-80
760,1,0,241,0,-241
761,1,1,1106,1373,267
762,1,0,130,0,-130
763,1,0,45,0,-45
764,0,0,39,0,-39
765,1,0,17,0,-17
766,1,1,1164,1214,50
767,1,0,255,0,-255
768,0,0,45,0,-45
769,1,1,459,1977,1518
770,1,0,38,0,-38
771,0,0,130,0,-130
772,1,1,353,1278,925
773,1,0,36,0,-36
774,1,1,479,2306,1827
775,1,1,53,1756,1703
776,0,0,6,0,-6
777,1,0,35,0,-35
778,0,0,7,0,-7
779,1,0,67,0,-67
780,1,0,142,0,-142
781,0,0,29,0,-29
782,1,0,62,0,-62
783,0,0,105,0,-105
784,1,0,29,0,-29
785,0,0,146,0,-146
786,1,0,9,0,-9
787,1,0,43,0,-43
788,1,0,36,0,-36
789,0,0,3,0,-3
790,1,0,36,0,-36
791,0,0,35,0,-35
792,1,1,217,1228,1011
793,0,0,37,0,-37
794,1,1,1062,1368,306
795,0,0,41,0,-41
796,1,1,195,1528,1333
797,0,0,4,0,-4
798,0,0,14,0,-14
799,0,0,45,0,-45
800,1,1,362,1483,1121
801,1,1,357,1603,1246
802,1,1,213,1362,1149
803,0,0,40,0,-40
804,1,0,67,0,-67
805,1,0,37,0,-37
806,1,0,13,0,-13
807,1,1,92,1711,1619
808,1,1,123,1257,1134
809,0,0,52,0,-52
810,1,0,34,0,-34
811,1,1,515,1326,811
812,1,0,29,0,-29
813,1,0,4,0,-4
814,1,0,21,0,-21
815,1,0,36,0,-36
816,1,1,403,2251,1848
817,0,0,135,0,-135
818,1,1,239,1372,1133
819,0,0,186,0,-186
820,1,0,132,0,-132
821,1,1,660,1351,691
822,0,0,8,0,-8
823,0,0,35,0,-35
824,1,1,602,1431,829
825,1,0,152,0,-152
826,1,0,3,0,-3
827,0,0,18,0,-18
828,1,1,314,1251,937
829,1,1,373,1221,848
830,0,0,84,0,-84
831,1,1,194,1581,1387
832,0,0,38,0,-38
833,0,0,12,0,-12
834,0,0,14,0,-14
835,0,0,34,0,-34
836,1,1,250,1218,968
837,0,0,53,0,-53
838,1,1,859,2819,1960
839,0,0,38,0,-38
840,1,1,964,1276,312
841,0,0,39,0,-39
842,0,0,35,0,-35
843,1,0,21,0,-21
844,0,0,3,0,-3
845,0,0,53,0,-53
846,1,1,469,2531,2062
847,0,0,27,0,-27
848,1,0,13,0,-13
849,1,0,16,0,-16
850,0,0,26,0,-26
851,1,1,290,1584,1294
852,0,0,11,0,-11
853,1,1,458,1790,1332
854,0,0,18,0,-18
855,1,0,110,0,-110
856,0,0,87,0,-87
857,1,1,35,1885,1850
858,1,1,24,1211,1187
859,0,0,40,0,-40
860,1,1,125,1311,1186
861,0,0,85,0,-85
862,0,0,23,0,-23
863,0,0,7,0,-7
864,1,1,675,1267,592
865,1,1,403,1343,940
866,0,0,7,0,-7
867,1,1,1105,4347,3242
868,0,0,10,0,-10
869,1,0,131,0,-131
870,1,0,0,0,0
871,1,1,110,1271,1161
872,1,1,1233,1539,306
873,0,0,146,0,-146
874,1,0,2,0,-2
875,0,0,32,0,-32
876,1,0,53,0,-53
877,0,0,16,0,-16
878,1,1,211,1308,1097
879,1,0,146,0,-146
880,0,0,25,0,-25
881,0,0,37,0,-37
882,1,1,188,1682,1494
883,0,0,0,0,0
884,0,0,45,0,-45
885,0,0,4,0,-4
886,0,0,87,0,-87
887,1,0,13,0,-13
888,1,1,264,1302,1038
889,0,0,187,0,-187
890,0,0,27,0,-27
891,0,0,164,0,-164
892,0,0,166,0,-166
893,0,0,15,0,-15
894,0,0,5,0,-5
895,1,1,138,1420,1282
896,0,0,6,0,-6
897,1,0,91,0,-91
898,0,0,48,0,-48
899,0,0,56,0,-56
900,1,1,932,2563,1631
901,1,0,59,0,-59
902,1,0,18,0,-18
903,0,0,96,0,-96
904,1,0,58,0,-58
905,0,0,51,0,-51
906,1,1,980,1437,457
907,1,0,2,0,-2
908,0,0,0,0,0
909,0,0,4,0,-4
910,0,0,150,0,-150
911,1,0,108,0,-108
912,1,0,43,0,-43
913,0,0,1,0,-1
914,0,0,111,0,-111
915,1,1,295,1579,1284
916,0,0,68,0,-68
917,1,0,22,0,-22
918,1,0,87,0,-87
919,0,0,74,0,-74
920,1,0,42,0,-42
921,1,0,63,0,-63
922,1,0,252,0,-252
923,1,1,651,1458,807
924,1,0,24,0,-24
925,1,1,577,1262,685
926,1,0,30,0,-30
927,1,0,25,0,-25
928,1,1,753,3082,2329
929,0,0,73,0,-73
930,1,1,308,1269,961
931,0,0,18,0,-18
932,1,1,58,1315,1257
933,1,1,777,1274,497
934,1,1,1029,1219,190
935,1,1,208,1481,1273
936,1,0,1,0,-1
937,1,0,0,0,0
938,1,0,21,0,-21
939,0,0,26,0,-26
940,1,0,56,0,-56
941,1,1,219,1662,1443
942,1,0,9,0,-9
943,1,0,23,0,-23
944,0,0,12,0,-12
945,1,1,1022,1527,505
946,1,1,530,1817,1287
947,1,1,127,1372,1245
948,1,1,829,1337,508
949,1,1,134,1486,1352
950,1,1,354,1202,848
951,0,0,90,0,-90
952,1,0,40,0,-40
953,1,0,28,0,-28
954,1,1,258,1309,1051
955,0,0,69,0,-69
956,1,0,1,0,-1
957,1,1,619,1251,632
958,0,0,21,0,-21
959,1,1,1084,2258,1174
960,0,0,146,0,-146
961,0,0,8,0,-8
962,0,0,40,0,-40
963,1,1,441,1245,804
964,0,0,14,0,-14
965,1,1,803,1585,782
966,0,0,31,0,-31
967,1,0,213,0,-213
968,0,0,27,0,-27
969,1,0,26,0,-26
970,1,1,180,1272,1092
971,0,0,39,0,-39
972,1,0,3,0,-3
973,1,1,1091,1300,209
974,0,0,4,0,-4
975,1,1,548,1265,717
976,1,1,1326,2559,1233
977,1,1,500,1609,1109
978,0,0,59,0,-59
979,0,0,47,0,-47
980,1,1,751,1662,911
981,1,1,205,1329,1124
982,0,0,24,0,-24
983,0,0,90,0,-90
984,0,0,36,0,-36
985,1,1,725,1372,647
986,1,1,124,1568,1444
987,0,0,18,0,-18
988,1,1,312,1656,1344
989,1,1,190,1872,1682
990,1,0,59,0,-59
991,1,0,86,0,-86
992,0,0,137,0,-137
993,0,0,24,0,-24
994,1,0,3,0,-3
995,1,0,7,0,-7
996,0,0,4,0,-4
997,1,0,30,0,-30
998,1,0,15,0,-15
999,1,1,36,1573,1537
1000,1,0,57,0,-57
1001,0,0,82,0,-82
1002,0,0,51,0,-51
1003,0,0,22,0,-22
1004,0,0,29,0,-29
1005,0,0,38,0,-38
1006,0,0,85,0,-85
1007,1,1,182,1249,1067
1008,0,0,41,0,-41
1009,1,0,11,0,-11
1010,1,0,4,0,-4
1011,1,1,1357,1256,-101
1012,1,0,33,0,-33
1013,0,0,22,0,-22
1014,1,0,186,0,-186
1015,1,0,100,0,-100
1016,0,0,23,0,-23
1017,0,0,1,0,-1
1018,1,1,588,1543,955
1019,0,0,7,0,-7
1020,1,0,22,0,-22
1021,0,0,21,0,-21
1022,1,0,66,0,-66
1023,1,0,47,0,-47
1024,0,0,10,0,-10
1025,1,0,130,0,-130
1026,0,0,22,0,-22
1027,1,0,0,0,0
1028,0,0,34,0,-34
1029,1,0,12,0,-12
1030,0,0,14,0,-14
1031,1,0,50,0,-50
1032,0,0,38,0,-38
1033,1,1,1100,1465,365
1034,1,1,315,1373,1058
1035,1,0,15,0,-15
1036,0,0,40,0,-40
1037,1,0,59,0,-59
1038,1,1,445,1359,914
1039,1,1,948,1967,1019
1040,1,0,70,0,-70
1041,0,0,7,0,-7
1042,0,0,149,0,-149
1043,0,0,31,0,-31
1044,1,1,84,1663,1579
1045,0,0,30,0,-30
1046,1,1,64,1226,1162
1047,1,1,209,1231,1022
1048,0,0,10,0,-10
1049,0,0,26,0,-26
1050,0,0,12,0,-12
1051,1,0,21,0,-21
1052,1,1,203,1267,1064
1053,0,0,21,0,-21
1054,1,1,95,1478,1383
1055,0,0,26,0,-26
1056,0,0,13,0,-13
1057,1,0,96,0,-96
1058,0,0,10,0,-10
1059,0,0,247,0,-247
1060,1,1,317,1903,1586
1061,1,1,287,1509,1222
1062,0,0,103,0,-103
1063,0,0,63,0,-63
1064,1,0,21,0,-21
1065,0,0,99,0,-99
1066,1,0,35,0,-35
1067,1,1,581,1574,993
1068,0,0,82,0,-82
1069,1,0,3,0,-3
1070,1,1,1135,1796,661
1071,0,0,2,0,-2
1072,0,0,6,0,-6
1073,0,0,146,0,-146
1074,0,0,54,0,-54
1075,1,0,90,0,-90
1076,0,0,108,0,-108
1077,1,1,1032,1725,693
1078,1,0,24,0,-24
1079,1,0,21,0,-21
1080,1,1,306,1850,1544
1081,0,0,59,0,-59
1082,1,0,33,0,-33
1083,1,0,29,0,-29
1084,1,1,1396,1296,-100
1085,0,0,58,0,-58
1086,0,0,14,0,-14
1087,1,0,34,0,-34
1088,0,0,2,0,-2
1089,0,0,118,0,-118
1090,0,0,35,0,-35
1091,0,0,119,0,-119
1092,1,1,1080,2504,1424
1093,1,1,133,1318,1185
1094,0,0,3,0,-3
1095,1,0,44,0,-44
1096,1,0,1,0,-1
1097,1,1,412,1311,899
1098,1,0,59,0,-59
1099,1,1,255,2444,2189
1100,0,0,28,0,-28
1101,1,1,329,1409,1080
1102,1,1,100,1630,1530
1103,0,0,41,0,-41
1104,0,0,26,0,-26
1105,1,0,95,0,-95
1106,0,0,40,0,-40
1107,1,0,24,0,-24
1108,0,0,268,0,-268
1109,1,0,31,0,-31
1110,0,0,104,0,-104
1111,1,1,829,1210,381
1112,1,0,39,0,-39
1113,1,0,4,0,-4
1114,0,0,32,0,-32
1115,0,0,25,0,-25
1116,1,0,2,0,-2
1117,1,1,443,1414,971
1118,1,0,82,0,-82
1119,0,0,13,0,-13
1120,1,0,155,0,-155
1121,1,0,0,0,0
1122,1,0,102,0,-102
1123,1,1,790,1320,530
1124,1,0,96,0,-96
1125,0,0,55,0,-55
1126,1,1,450,1747,1297
1127,1,0,12,0,-12
1128,1,0,11,0,-11
1129,1,0,195,0,-195
1130,1,0,12,0,-12
1131,0,0,49,0,-49
1132,1,1,809,2193,1384
1133,0,0,50,0,-50
1134,0,0,180,0,-180
1135,1,0,178,0,-178
1136,1,0,54,0,-54
1137,0,0,0,0,0
1138,1,0,56,0,-56
1139,0,0,90,0,-90
1140,0,0,12,0,-12
1141,1,1,103,1278,1175
1142,1,1,703,1811,1108
1143,1,1,1306,1227,-79
1144,1,0,39,0,-39
1145,1,1,1241,1269,28
1146,0,0,34,0,-34
1147,1,1,418,1337,919
1148,1,0,4,0,-4
1149,1,0,39,0,-39
1150,0,0,37,0,-37
1151,0,0,37,0,-37
1152,0,0,28,0,-28
1153,1,0,50,0,-50
1154,0,0,9,0,-9
1155,1,1,258,1235,977
1156,0,0,45,0,-45
1157,1,0,29,0,-29
1158,1,0,39,0,-39
1159,1,0,11,0,-11
1160,0,0,48,0,-48
1161,1,1,1581,1809,228
1162,0,0,2,0,-2
1163,0,0,22,0,-22
1164,1,0,44,0,-44
1165,1,0,46,0,-46
1166,1,0,51,0,-51
1167,0,0,38,0,-38
1168,0,0,68,0,-68
1169,1,0,78,0,-78
1170,0,0,197,0,-197
1171,1,1,133,1600,1467
1172,1,1,541,2068,1527
1173,1,1,1124,2744,1620
1174,1,1,181,1289,1108
1175,1,0,19,0,-19
1176,1,0,0,0,0
1177,1,0,91,0,-91
1178,1,1,857,1837,980
1179,1,0,9,0,-9
1180,0,0,25,0,-25
1181,1,0,35,0,-35
1182,0,0,4,0,-4
1183,1,0,1,0,-1
1184,1,1,490,1259,769
1185,0,0,1,0,-1
1186,0,0,29,0,-29
1187,1,0,25,0,-25
1188,1,1,1448,1318,-130
1189,1,1,156,1397,1241
1190,1,1,334,1214,880
1191,1,1,1090,1292,202
1192,0,0,16,0,-16
1193,1,1,721,1413,692
1194,1,1,114,1257,1143
1195,1,0,34,0,-34
1196,0,0,3,0,-3
1197,0,0,66,0,-66
1198,1,1,548,1465,917
1199,1,1,1972,2188,216
1200,0,0,47,0,-47
1201,0,0,5,0,-5
1202,0,0,50,0,-50
1203,1,1,75,1209,1134
1204,1,0,52,0,-52
1205,1,1,145,1224,1079
1206,1,0,114,0,-114
1207,1,0,76,0,-76
1208,0,0,91,0,-91
1209,1,1,337,1491,1154
1210,1,0,284,0,-284
1211,0,0,5,0,-5
1212,0,0,4,0,-4
1213,0,0,81,0,-81
1214,1,0,30,0,-30
1215,1,0,0,0,0
1216,1,1,584,2489,1905
1217,1,1,1068,1258,190
1218,0,0,28,0,-28
1219,1,0,22,0,-22
1220,1,0,41,0,-41
1221,0,0,68,0,-68
1222,0,0,95,0,-95
1223,1,1,398,1300,902
1224,1,1,131,2010,1879
1225,0,0,85,0,-85
1226,0,0,1,0,-1
1227,1,0,113,0,-113
1228,1,0,75,0,-75
1229,1,1,1155,1763,608
1230,1,1,492,1445,953
1231,0,0,5,0,-5
1232,1,0,36,0,-36
1233,1,0,3,0,-3
1234,1,0,72,0,-72
1235,0,0,31,0,-31
1236,1,0,19,0,-19
1237,0,0,123,0,-123
1238,0,0,4,0,-4
1239,1,0,3,0,-3
1240,0,0,9,0,-9
1241,0,0,8,0,-8
1242,0,0,25,0,-25
1243,0,0,12,0,-12
1244,1,1,144,1398,1254
1245,0,0,8,0,-8
1246,1,1,293,1265,972
1247,1,1,278,1235,957
1248,1,1,690,1260,570
1249,1,1,1931,1201,-730
1250,0,0,44,0,-44
1251,1,1,184,3665,3481
1252,1,1,922,1364,442
1253,0,0,106,0,-106
1254,1,1,289,1562,1273
1255,1,1,285,1657,1372
1256,0,0,50,0,-50
1257,0,0,39,0,-39
1258,1,1,441,1601,1160
1259,0,0,90,0,-90
1260,1,1,485,1843,1358
1261,0,0,49,0,-49
1262,0,0,62,0,-62
1263,0,0,49,0,-49
1264,0,0,41,0,-41
1265,1,1,443,1437,994
1266,0,0,11,0,-11
1267,0,0,149,0,-149
1268,1,1,119,1209,1090
1269,0,0,117,0,-117
1270,1,0,35,0,-35
1271,1,1,270,1226,956
1272,1,1,358,1374,1016
1273,0,0,132,0,-132
1274,1,1,285,1658,1373
1275,0,0,17,0,-17
1276,0,0,176,0,-176
1277,0,0,30,0,-30
1278,1,1,304,6950,6646
1279,1,1,399,1699,1300
1280,0,0,6,0,-6
1281,1,0,149,0,-149
1282,0,0,62,0,-62
1283,0,0,70,0,-70
1284,0,0,53,0,-53
1285,1,1,337,1538,1201
1286,1,0,10,0,-10
1287,1,0,104,0,-104
1288,1,1,1081,1285,204
1289,0,0,72,0,-72
1290,1,0,24,0,-24
1291,1,0,144,0,-144
1292,0,0,26,0,-26
1293,1,0,65,0,-65
1294,1,0,87,0,-87
1295,0,0,71,0,-71
1296,1,0,24,0,-24
1297,1,1,1032,1377,345
1298,1,1,129,1929,1800
1299,1,1,307,1779,1472
1300,1,1,470,1307,837
1301,0,0,53,0,-53
1302,0,0,82,0,-82
1303,1,1,527,1805,1278
1304,1,1,186,1345,1159
1305,0,0,133,0,-133
1306,1,1,687,1625,938
1307,1,1,438,1238,800
1308,1,1,325,1238,913
1309,1,1,1501,2463,962
1310,0,0,21,0,-21
1311,0,0,43,0,-43
1312,0,0,16,0,-16
1313,1,1,162,1228,1066
1314,0,0,3,0,-3
1315,0,0,24,0,-24
1316,0,0,70,0,-70
1317,0,0,14,0,-14
1318,0,0,40,0,-40
1319,0,0,38,0,-38
1320,0,0,3,0,-3
1321,1,1,1428,1388,-40
1322,1,0,28,0,-28
1323,1,1,845,1459,614
1324,1,1,478,1420,942
1325,1,0,1,0,-1
1326,0,0,39,0,-39
1327,1,0,35,0,-35
1328,1,0,54,0,-54
1329,0,0,115,0,-115
1330,1,0,325,0,-325
1331,1,0,54,0,-54
1332,0,0,24,0,-24
1333,1,0,6,0,-6
1334,1,1,531,1711,1180
1335,1,1,302,2563,2261
1336,1,1,181,1396,1215
1337,1,0,38,0,-38
1338,1,1,804,1214,410
1339,0,0,50,0,-50
1340,1,0,32,0,-32
1341,1,1,21,1219,1198
1342,1,0,65,0,-65
1343,0,0,16,0,-16
1344,1,0,11,0,-11
1345,1,1,135,1274,1139
1346,0,0,0,0,0
1347,0,0,37,0,-37
1348,1,1,132,1449,1317
1349,1,0,12,0,-12
1350,1,0,4,0,-4
1351,1,0,2,0,-2
1352,0,0,89,0,-89
1353,1,1,416,1331,915
1354,1,0,212,0,-212
1355,1,1,133,1302,1169
1356,1,1,1713,1863,150
1357,0,0,5,0,-5
1358,0,0,25,0,-25
1359,0,0,122,0,-122
1360,0,0,27,0,-27
1361,1,0,42,0,-42
1362,1,0,2,0,-2
1363,1,1,683,1305,622
1364,0,0,34,0,-34
1365,1,0,52,0,-52
1366,1,1,69,1590,1521
1367,1,1,1653,1404,-249
1368,1,1,575,1600,1025
1369,0,0,39,0,-39
1370,1,0,6,0,-6
1371,1,0,32,0,-32
1372,1,0,28,0,-28
1373,1,1,202,2045,1843
1374,1,1,194,1512,1318
1375,0,0,12,0,-12
1376,1,1,109,3068,2959
1377,1,1,165,1230,1065
1378,1,1,1958,1279,-679
1379,1,0,55,0,-55
1380,1,0,52,0,-52
1381,0,0,20,0,-20
1382,1,1,97,1317,1220
1383,1,0,179,0,-179
1384,1,1,170,1650,1480
1385,1,1,347,1286,939
1386,1,0,21,0,-21
1387,0,0,137,0,-137
1388,1,0,98,0,-98
1389,1,0,13,0,-13
1390,1,0,13,0,-13
1391,0,0,9,0,-9
1392,1,0,15,0,-15
1393,1,0,167,0,-167
1394,1,0,172,0,-172
1395,1,0,47,0,-47
1396,0,0,36,0,-36
1397,1,0,36,0,-36
1398,0,0,161,0,-161
1399,1,0,109,0,-109
1400,1,0,27,0,-27
1401,1,1,102,1225,1123
1402,1,0,14,0,-14
1403,1,0,85,0,-85
1404,0,0,158,0,-158
1405,1,0,9,0,-9
1406,1,1,428,1593,1165
1407,0,0,5,0,-5
1408,0,0,25,0,-25
1409,1,0,21,0,-21
1410,0,0,32,0,-32
1411,0,0,16,0,-16
1412,1,1,455,1240,785
1413,0,0,23,0,-23
1414,0,0,117,0,-117
1415,1,0,33,0,-33
1416,0,0,25,0,-25
1417,0,0,63,0,-63
1418,1,1,225,1700,1475
1419,0,0,53,0,-53
1420,1,1,1217,1284,67
1421,1,1,242,1268,1026
1422,1,0,39,0,-39
1423,1,1,915,1289,374
1424,1,0,40,0,-40
1425,1,1,466,2151,1685
1426,0,0,9,0,-9
1427,1,0,104,0,-104
1428,0,0,47,0,-47
1429,1,0,159,0,-159
1430,1,0,6,0,-6
1431,0,0,121,0,-121
1432,1,0,32,0,-32
1433,0,0,32,0,-32
1434,1,0,4,0,-4
1435,1,1,2258,1368,-890
1436,0,0,8,0,-8
1437,1,0,4,0,-4
1438,0,0,9,0,-9
1439,0,0,51,0,-51
1440,0,0,50,0,-50
1441,0,0,41,0,-41
1442,0,0,74,0,-74
1443,0,0,34,0,-34
1444,0,0,91,0,-91
1445,0,0,84,0,-84
1446,0,0,15,0,-15
1447,1,1,437,10785,10348
1448,0,0,17,0,-17
1449,0,0,243,0,-243
1450,1,1,1156,2349,1193
1451,0,0,25,0,-25
1452,1,0,120,0,-120
1453,1,0,28,0,-28
1454,1,1,2183,1335,-848
1455,1,0,3,0,-3
1456,1,1,406,1795,1389
1457,0,0,95,0,-95
1458,1,0,20,0,-20
1459,1,1,76,1226,1150
1460,0,0,58,0,-58
1461,0,0,22,0,-22
1462,1,1,77,1345,1268
1463,1,1,423,1251,828
1464,1,0,38,0,-38
1465,1,1,588,1724,1136
1466,1,0,15,0,-15
1467,1,0,101,0,-101
1468,1,1,463,1637,1174
1469,0,0,244,0,-244
1470,1,1,523,1395,872
1471,0,0,41,0,-41
1472,1,0,0,0,0
1473,0,0,189,0,-189
1474,0,0,128,0,-128
1475,1,0,6,0,-6
1476,0,0,64,0,-64
1477,0,0,111,0,-111
1478,0,0,57,0,-57
1479,1,0,18,0,-18
1480,0,0,142,0,-142
1481,1,1,74,1392,1318
1482,1,1,506,2535,2029
1483,0,0,219,0,-219
1484,1,1,162,1651,1489
1485,0,0,123,0,-123
1486,0,0,181,0,-181
1487,0,0,19,0,-19
1488,0,0,19,0,-19
1489,0,0,112,0,-112
1490,0,0,46,0,-46
1491,0,0,67,0,-67
1492,0,0,18,0,-18
1493,0,0,93,0,-93
1494,1,0,81,0,-81
1495,0,0,0,0,0
1496,1,1,240,1769,1529
1497,0,0,178,0,-178
1498,0,0,36,0,-36
1499,1,1,300,1391,1091
1500,0,0,40,0,-40
1501,0,0,9,0,-9
1502,0,0,52,0,-52
1503,0,0,1,0,-1
1504,0,0,164,0,-164
1505,0,0,43,0,-43
1506,0,0,15,0,-15
1507,1,0,21,0,-21
1508,1,1,123,1980,1857
1509,0,0,43,0,-43
1510,1,0,9,0,-9
1511,0,0,55,0,-55
1512,1,0,103,0,-103
1513,1,0,2,0,-2
1514,0,0,21,0,-21
1515,0,0,6,0,-6
1516,1,1,282,1397,1115
1517,1,0,41,0,-41
1518,1,1,781,1605,824
1519,0,0,21,0,-21
1520,0,0,24,0,-24
1521,0,0,36,0,-36
1522,1,1,335,2232,1897
1523,0,0,28,0,-28
1524,0,0,21,0,-21
1525,1,0,76,0,-76
1526,1,0,5,0,-5
1527,1,1,507,1746,1239
1528,0,0,38,0,-38
1529,0,0,2,0,-2
1530,1,0,8,0,-8
1531,1,0,103,0,-103
1532,1,0,136,0,-136
1533,0,0,46,0,-46
1534,0,0,8,0,-8
1535,1,1,459,1442,983
1536,0,0,28,0,-28
1537,0,0,7,0,-7
1538,1,1,882,1826,944
1539,0,0,71,0,-71
1540,1,0,41,0,-41
1541,1,0,149,0,-149
1542,1,0,25,0,-25
1543,0,0,22,0,-22
1544,1,1,454,1273,819
1545,1,0,45,0,-45
1546,0,0,111,0,-111
1547,1,1,638,1382,744
1548,1,1,678,1295,617
1549,1,1,296,1629,1333
1550,0,0,18,0,-18
1551,0,0,21,0,-21
1552,1,0,64,0,-64
1553,0,0,38,0,-38
1554,1,0,60,0,-60
1555,1,0,45,0,-45
1556,1,0,10,0,-10
1557,0,0,114,0,-114
1558,0,0,3,0,-3
1559,1,0,1,0,-1
1560,1,0,17,0,-17
1561,1,1,658,1447,789
1562,1,0,4,0,-4
1563,1,0,87,0,-87
1564,0,0,14,0,-14
1565,1,0,8,0,-8
1566,1,0,77,0,-77
1567,0,0,49,0,-49
1568,0,0,17,0,-17
1569,1,0,2,0,-2
1570,0,0,50,0,-50
1571,1,0,7,0,-7
1572,1,0,49,0,-49
1573,1,0,67,0,-67
1574,0,0,97,0,-97
1575,1,1,34,1778,1744
1576,1,1,415,2756,2341
1577,0,0,44,0,-44
1578,1,0,0,0,0
1579,1,0,20,0,-20
1580,0,0,124,0,-124
1581,1,0,10,0,-10
1582,0,0,27,0,-27
1583,0,0,51,0,-51
1584,1,1,1226,1510,284
1585,0,0,12,0,-12
1586,0,0,24,0,-24
1587,0,0,5,0,-5
1588,1,1,433,1297,864
1589,1,1,974,1356,382
1590,1,1,123,1438,1315
1591,0,0,243,0,-243
1592,0,0,6,0,-6
1593,1,1,139,1231,1092
1594,1,1,290,3012,2722
1595,1,1,605,1319,714
1596,1,1,352,1858,1506
1597,1,1,88,1360,1272
1598,0,0,50,0,-50
1599,1,0,37,0,-37
1600,1,1,100,1593,1493
1601,1,1,245,1582,1337
1602,1,1,250,1314,1064
1603,1,1,570,2512,1942
1604,0,0,29,0,-29
1605,0,0,24,0,-24
1606,0,0,17,0,-17
1607,0,0,103,0,-103
1608,1,1,357,1599,1242
1609,1,0,57,0,-57
1610,0,0,42,0,-42
1611,0,0,163,0,-163
1612,0,0,35,0,-35
1613,1,1,700,1305,605
1614,1,0,10,0,-10
1615,0,0,2,0,-2
1616,1,1,29,1568,1539
1617,1,0,116,0,-116
1618,1,0,61,0,-61
1619,0,0,137,0,-137
1620,1,1,773,1600,827
1621,1,0,147,0,-147
1622,1,1,282,1610,1328
1623,0,0,38,0,-38
1624,1,0,35,0,-35
1625,0,0,51,0,-51
1626,0,0,14,0,-14
1627,1,0,53,0,-53
1628,1,0,53,0,-53
1629,0,0,29,0,-29
1630,0,0,3,0,-3
1631,1,0,8,0,-8
1632,0,0,60,0,-60
1633,0,0,7,0,-7
1634,1,1,1333,2201,868
1635,0,0,23,0,-23
1636,1,1,40,1515,1475
1637,0,0,92,0,-92
1638,1,1,2142,1564,-578
1639,0,0,16,0,-16
1640,1,0,12,0,-12
1641,1,0,25,0,-25
1642,1,0,7,0,-7
1643,1,0,0,0,0
1644,0,0,8,0,-8
1645,1,0,15,0,-15
1646,0,0,64,0,-64
1647,1,1,91,1415,1324
1648,0,0,30,0,-30
1649,1,0,64,0,-64
1650,1,1,224,1774,1550
1651,0,0,14,0,-14
1652,0,0,45,0,-45
1653,1,1,254,1452,1198
1654,1,1,212,1476,1264
1655,1,0,84,0,-84
1656,1,1,111,1454,1343
1657,1,1,629,1515,886
1658,0,0,109,0,-109
1659,0,0,140,0,-140
1660,0,0,16,0,-16
1661,1,0,10,0,-10
1662,1,0,34,0,-34
1663,1,0,49,0,-49
1664,1,1,87,1356,1269
1665,1,1,281,3442,3161
1666,1,1,748,1273,525
1667,1,0,48,0,-48
1668,1,0,18,0,-18
1669,1,0,2,0,-2
1670,0,0,61,0,-61
1671,0,0,31,0,-31
1672,1,0,61,0,-61
1673,0,0,43,0,-43
1674,0,0,8,0,-8
1675,1,1,325,1276,951
1676,0,0,60,0,-60
1677,0,0,21,0,-21
1678,1,1,367,1675,1308
1679,0,0,58,0,-58
1680,0,0,20,0,-20
1681,0,0,36,0,-36
1682,1,0,4,0,-4
1683,0,0,6,0,-6
1684,1,1,766,1500,734
1685,0,0,11,0,-11
1686,1,0,45,0,-45
1687,1,1,528,1388,860
1688,0,0,56,0,-56
1689,1,0,120,0,-120
1690,0,0,9,0,-9
1691,1,1,178,1341,1163
1692,1,0,59,0,-59
1693,1,0,116,0,-116
1694,0,0,14,0,-14
1695,0,0,43,0,-43
1696,0,0,16,0,-16
1697,1,1,186,1480,1294
1698,0,0,120,0,-120
1699,1,1,96,2042,1946
1700,0,0,33,0,-33
1701,0,0,33,0,-33
1702,0,0,38,0,-38
1703,0,0,31,0,-31
1704,1,1,201,1212,1011
1705,1,1,260,2161,1901
1706,0,0,17,0,-17
1707,1,1,687,1514,827
1708,1,0,18,0,-18
1709,0,0,281,0,-281
1710,1,0,1,0,-1
1711,1,1,297,1311,1014
1712,1,1,489,2121,1632
1713,0,0,2,0,-2
1714,1,0,129,0,-129
1715,0,0,34,0,-34
1716,0,0,75,0,-75
1717,0,0,38,0,-38
1718,1,1,224,1371,1147
1719,1,1,438,1526,1088
1720,0,0,96,0,-96
1721,0,0,37,0,-37
1722,1,1,129,1251,1122
1723,1,1,811,1268,457
1724,1,1,341,1965,1624
1725,1,1,478,1280,802
1726,1,0,61,0,-61
1727,1,0,41,0,-41
1728,0,0,2,0,-2
1729,0,0,13,0,-13
1730,1,1,169,2088,1919
1731,0,0,212,0,-212
1732,1,0,73,0,-73
1733,1,0,24,0,-24
1734,0,0,16,0,-16
1735,0,0,56,0,-56
1736,0,0,53,0,-53
1737,0,0,22,0,-22
1738,1,1,163,1443,1280
1739,1,1,176,1522,1346
1740,1,1,407,1580,1173
1741,1,1,93,1239,1146
1742,0,0,55,0,-55
1743,1,0,29,0,-29
1744,1,0,41,0,-41
1745,1,0,48,0,-48
1746,1,1,53,4794,4741
1747,0,0,65,0,-65
1748,0,0,4,0,-4
1749,0,0,165,0,-165
1750,1,1,335,1509,1174
1751,1,0,51,0,-51
1752,1,0,22,0,-22
1753,0,0,106,0,-106
1754,1,1,631,1443,812
1755,1,0,67,0,-67
1756,0,0,49,0,-49
1757,0,0,91,0,-91
1758,1,1,305,1325,1020
1759,0,0,12,0,-12
1760,0,0,6,0,-6
1761,1,1,213,1269,1056
1762,0,0,3,0,-3
1763,1,1,1309,1307,-2
1764,0,0,118,0,-118
1765,1,1,1138,1484,346
1766,0,0,5,0,-5
1767,0,0,153,0,-153
1768,1,0,7,0,-7
1769,1,0,24,0,-24
1770,1,0,14,0,-14
1771,1,1,833,1841,1008
1772,1,1,1053,1284,231
1773,1,0,3,0,-3
1774,0,0,86,0,-86
1775,0,0,56,0,-56
1776,0,0,25,0,-25
1777,1,1,234,1242,1008
1778,0,0,5,0,-5
1779,0,0,74,0,-74
1780,1,1,732,1264,532
1781,0,0,20,0,-20
1782,0,0,13,0,-13
1783,1,1,200,1541,1341
1784,0,0,42,0,-42
1785,0,0,26,0,-26
1786,1,1,381,1453,1072
1787,1,1,176,3008,2832
1788,1,1,388,1557,1169
1789,1,0,27,0,-27
1790,0,0,124,0,-124
1791,1,1,1065,1361,296
1792,1,0,73,0,-73
1793,0,0,1,0,-1
1794,1,0,105,0,-105
1795,1,0,8,0,-8
1796,0,0,22,0,-22
1797,0,0,59,0,-59
1798,0,0,11,0,-11
1799,1,0,7,0,-7
1800,0,0,59,0,-59
1801,1,0,46,0,-46
1802,1,0,7,0,-7
1803,1,0,0,0,0
1804,0,0,29,0,-29
1805,0,0,160,0,-160
1806,0,0,85,0,-85
1807,1,0,68,0,-68
1808,1,0,30,0,-30
1809,1,0,13,0,-13
1810,1,1,225,1332,1107
1811,1,1,59,1346,1287
1812,1,1,266,1388,1122
1813,1,0,65,0,-65
1814,1,1,1016,1531,515
1815,1,1,289,1538,1249
1816,1,0,11,0,-11
1817,0,0,17,0,-17
1818,0,0,33,0,-33
1819,1,0,24,0,-24
1820,1,0,8,0,-8
1821,1,1,1058,1639,581
1822,0,0,16,0,-16
1823,0,0,96,0,-96
1824,0,0,1,0,-1
1825,0,0,61,0,-61
1826,1,1,967,1568,601
1827,0,0,111,0,-111
1828,0,0,10,0,-10
1829,1,0,116,0,-116
1830,1,0,83,0,-83
1831,1,0,8,0,-8
1832,1,1,2187,1955,-232
1833,1,0,19,0,-19
1834,0,0,100,0,-100
1835,0,0,100,0,-100
1836,0,0,90,0,-90
1837,0,0,32,0,-32
1838,0,0,38,0,-38
1839,0,0,2,0,-2
1840,1,0,33,0,-33
1841,1,0,43,0,-43
1842,1,0,45,0,-45
1843,1,1,468,1217,749
1844,0,0,35,0,-35
1845,1,1,65,1663,1598
1846,0,0,152,0,-152
1847,1,0,126,0,-126
1848,1,0,171,0,-171
1849,1,0,13,0,-13
1850,1,0,24,0,-24
1851,1,0,7,0,-7
1852,1,0,2,0,-2
1853,0,0,37,0,-37
1854,1,0,25,0,-25
1855,0,0,23,0,-23
1856,0,0,41,0,-41
1857,1,0,22,0,-22
1858,1,1,87,1204,1117
1859,1,0,53,0,-53
1860,1,1,663,1872,1209
1861,0,0,23,0,-23
1862,1,0,28,0,-28
1863,0,0,17,0,-17
1864,0,0,123,0,-123
1865,1,1,115,1459,1344
1866,1,1,238,1310,1072
1867,0,0,4,0,-4
1868,0,0,40,0,-40
1869,0,0,98,0,-98
1870,1,1,310,1586,1276
1871,0,0,49,0,-49
1872,0,0,75,0,-75
1873,0,0,53,0,-53
1874,0,0,73,0,-73
1875,1,1,199,1229,1030
1876,1,0,88,0,-88
1877,1,0,109,0,-109
1878,1,0,69,0,-69
1879,1,1,348,3269,2921
1880,1,0,69,0,-69
1881,1,0,25,0,-25
1882,0,0,0,0,0
1883,1,1,236,1478,1242
1884,0,0,0,0,0
1885,0,0,7,0,-7
1886,1,0,67,0,-67
1887,1,1,436,1258,822
1888,1,1,872,2510,1638
1889,1,0,17,0,-17
1890,1,1,528,1585,1057
1891,1,1,245,1200,955
1892,1,0,12,0,-12
1893,1,1,140,2840,2700
1894,1,0,41,0,-41
1895,1,1,137,2310,2173
1896,0,0,20,0,-20
1897,1,1,2118,1538,-580
1898,0,0,67,0,-67
1899,1,1,735,1338,603
1900,1,1,1402,1864,462
1901,1,1,1009,1211,202
1902,1,0,33,0,-33
1903,1,1,74,2086,2012
1904,0,0,208,0,-208
1905,1,1,832,1206,374
1906,0,0,28,0,-28
1907,1,1,235,2406,2171
1908,1,1,777,1669,892
1909,0,0,37,0,-37
1910,0,0,107,0,-107
1911,0,0,34,0,-34
1912,1,1,230,1205,975
1913,0,0,2,0,-2
1914,0,0,45,0,-45
1915,1,1,683,1402,719
1916,1,1,577,1948,1371
1917,0,0,36,0,-36
1918,1,1,209,1245,1036
1919,0,0,37,0,-37
1920,1,1,1931,1485,-446
1921,1,1,58,2522,2464
1922,0,0,103,0,-103
1923,0,0,130,0,-130
1924,1,1,881,1556,675
1925,1,0,7,0,-7
1926,1,0,6,0,-6
1927,0,0,57,0,-57
1928,1,1,625,1238,613
1929,1,0,13,0,-13
1930,0,0,76,0,-76
1931,0,0,6,0,-6
1932,0,0,14,0,-14
1933,0,0,123,0,-123
1934,1,1,735,2403,1668
1935,1,0,84,0,-84
1936,0,0,48,0,-48
1937,0,0,18,0,-18
1938,1,0,48,0,-48
1939,0,0,102,0,-102
1940,1,1,55,1845,1790
1941,1,1,209,1280,1071
1942,1,0,57,0,-57
1943,1,1,2048,1376,-672
1944,1,1,499,1875,1376
1945,1,1,334,5425,5091
1946,0,0,157,0,-157
1947,1,0,54,0,-54
1948,0,0,11,0,-11
1949,0,0,149,0,-149
1950,0,0,25,0,-25
1951,1,0,97,0,-97
1952,0,0,21,0,-21
1953,0,0,30,0,-30
1954,0,0,52,0,-52
1955,1,1,54,1233,1179
1956,1,0,5,0,-5
1957,1,1,450,2080,1630
1958,0,0,96,0,-96
1959,0,0,0,0,0
1960,1,1,265,1222,957
1961,1,0,12,0,-12
1962,1,0,114,0,-114
1963,0,0,136,0,-136
1964,0,0,57,0,-57
1965,1,1,164,1936,1772
1966,1,1,334,1220,886
1967,1,0,34,0,-34
1968,1,1,152,1298,1146
1969,1,1,732,4339,3607
1970,1,1,187,1236,1049
1971,0,0,26,0,-26
1972,1,1,1870,1331,-539
1973,1,0,88,0,-88
1974,0,0,150,0,-150
1975,1,1,1120,1360,240
1976,0,0,8,0,-8
1977,1,1,225,1260,1035
1978,1,1,1767,1219,-548
1979,0,0,5,0,-5
1980,0,0,156,0,-156
1981,1,0,110,0,-110
1982,1,1,234,2366,2132
1983,1,0,78,0,-78
1984,1,1,494,1574,1080
1985,1,0,79,0,-79
1986,0,0,79,0,-79
1987,1,1,123,1372,1249
1988,0,0,56,0,-56
1989,0,0,0,0,0
1990,1,1,581,1201,620
1991,1,0,63,0,-63
1992,1,0,45,0,-45
1993,0,0,13,0,-13
1994,1,0,24,0,-24
1995,1,1,746,1664,918
1996,0,0,4,0,-4
1997,0,0,12,0,-12
1998,1,0,204,0,-204
1999,1,0,51,0,-51
2000,1,1,788,3323,2535
2001,1,0,83,0,-83
2002,1,0,112,0,-112
2003,1,1,108,1583,1475
2004,1,1,109,1347,1238
2005,1,1,731,1290,559
2006,1,0,7,0,-7
2007,1,1,306,1267,961
2008,0,0,2,0,-2
2009,1,1,1116,1516,400
2010,1,0,378,0,-378
2011,1,0,52,0,-52
2012,1,1,526,1676,1150
2013,0,0,24,0,-24
2014,0,0,107,0,-107
2015,0,0,3,0,-3
2016,1,0,146,0,-146
2017,0,0,75,0,-75
2018,1,1,104,1545,1441
2019,1,0,47,0,-47
2020,1,1,88,1251,1163
2021,1,0,38,0,-38
2022,1,0,12,0,-12
2023,0,0,10,0,-10
2024,1,0,74,0,-74
2025,1,0,26,0,-26
2026,1,1,599,1434,835
2027,0,0,48,0,-48
2028,0,0,52,0,-52
2029,1,1,1608,1742,134
2030,1,1,186,1348,1162
2031,1,0,78,0,-78
2032,1,1,591,1224,633
2033,0,0,118,0,-118
2034,1,0,5,0,-5
2035,0,0,164,0,-164
2036,0,0,18,0,-18
2037,0,0,6,0,-6
2038,1,1,100,1370,1270
2039,1,1,294,1286,992
2040,1,0,80,0,-80
2041,1,1,200,1651,1451
2042,1,1,489,1512,1023
2043,1,0,25,0,-25
2044,0,0,11,0,-11
2045,1,1,1304,1317,13
2046,1,1,32,1795,1763
2047,1,1,954,2104,1150
2048,0,0,87,0,-87
2049,1,1,403,1304,901
2050,0,0,27,0,-27
2051,0,0,55,0,-55
2052,0,0,124,0,-124
2053,0,0,18,0,-18
2054,1,1,517,1647,1130
2055,1,1,226,1204,978
2056,1,1,3724,1216,-2508
2057,0,0,15,0,-15
2058,1,0,15,0,-15
2059,1,1,121,1328,1207
2060,0,0,78,0,-78
2061,0,0,43,0,-43
2062,1,1,106,1274,1168
2063,1,0,40,0,-40
2064,1,0,22,0,-22
2065,1,1,237,1600,1363
2066,1,1,839,1837,998
2067,1,1,143,1241,1098
2068,1,0,13,0,-13
2069,1,1,1050,1250,200
2070,0,0,37,0,-37
2071,1,0,157,0,-157
2072,1,0,218,0,-218
2073,1,1,320,1309,989
2074,0,0,78,0,-78
2075,0,0,227,0,-227
2076,0,0,1,0,-1
2077,0,0,118,0,-118
2078,0,0,32,0,-32
2079,0,0,55,0,-55
2080,0,0,16,0,-16
2081,0,0,7,0,-7
2082,1,0,33,0,-33
2083,1,0,82,0,-82
2084,1,1,132,1205,1073
2085,1,1,329,3684,3355
2086,1,1,174,1296,1122
2087,0,0,17,0,-17
2088,1,0,41,0,-41
2089,0,0,10,0,-10
2090,1,0,170,0,-170
2091,1,0,48,0,-48
2092,0,0,17,0,-17
2093,1,1,403,1496,1093
2094,1,1,240,1375,1135
2095,1,1,391,2143,1752
2096,1,1,435,1226,791
2097,1,0,48,0,-48
2098,0,0,1,0,-1
2099,0,0,75,0,-75
2100,0,0,53,0,-53
2101,1,1,263,1391,1128
2102,1,0,2,0,-2
2103,1,0,48,0,-48
2104,1,1,53,2019,1966
2105,0,0,44,0,-44
2106,0,0,25,0,-25
2107,0,0,18,0,-18
2108,1,1,888,1307,419
2109,1,0,5,0,-5
2110,0,0,88,0,-88
2111,1,1,1772,1488,-284
2112,1,1,167,1256,1089
2113,0,0,92,0,-92
2114,1,0,12,0,-12
2115,1,1,164,1550,1386
2116,1,0,90,0,-90
2117,1,1,160,1467,1307
2118,0,0,32,0,-32
2119,0,0,10,0,-10
2120,1,1,107,1389,1282
2121,0,0,22,0,-22
2122,1,1,112,1955,1843
2123,0,0,68,0,-68
2124,1,0,47,0,-47
2125,1,1,2542,2282,-260
2126,1,0,191,0,-191
2127,1,1,160,1977,1817
2128,1,0,17,0,-17
2129,1,1,50,1200,1150
2130,1,1,249,1393,1144
2131,1,0,43,0,-43
2132,0,0,147,0,-147
2133,0,0,18,0,-18
2134,0,0,50,0,-50
2135,1,0,226,0,-226
2136,1,0,1,0,-1
2137,1,1,795,1215,420
2138,1,0,8,0,-8
2139,1,1,496,1547,1051
2140,0,0,38,0,-38
2141,0,0,14,0,-14
2142,0,0,32,0,-32
2143,1,0,16,0,-16
2144,0,0,17,0,-17
2145,1,1,148,1250,1102
2146,0,0,31,0,-31
2147,0,0,15,0,-15
2148,1,1,513,1267,754
2149,0,0,71,0,-71
2150,0,0,83,0,-83
2151,1,0,115,0,-115
2152,1,0,81,0,-81
2153,1,0,31,0,-31
2154,1,1,32,1590,1558
2155,0,0,22,0,-22
2156,0,0,10,0,-10
2157,1,0,38,0,-38
2158,1,1,23,1634,1611
2159,0,0,114,0,-114
2160,0,0,13,0,-13
2161,1,1,44,2098,2054
2162,0,0,12,0,-12
2163,1,1,572,1652,1080
2164,0,0,61,0,-61
2165,1,1,205,1734,1529
2166,0,0,44,0,-44
2167,1,0,62,0,-62
2168,1,1,1121,1310,189
2169,1,1,110,1722,1612
2170,1,0,66,0,-66
2171,0,0,87,0,-87
2172,1,0,2,0,-2
2173,1,0,42,0,-42
2174,0,0,40,0,-40
2175,0,0,2,0,-2
2176,0,0,101,0,-101
2177,1,0,31,0,-31
2178,0,0,30,0,-30
2179,0,0,23,0,-23
2180,1,0,26,0,-26
2181,1,1,1138,4231,3093
2182,1,0,91,0,-91
2183,0,0,49,0,-49
2184,1,0,29,0,-29
2185,0,0,16,0,-16
2186,1,1,747,1272,525
2187,0,0,10,0,-10
2188,1,0,5,0,-5
2189,1,1,97,2285,2188
2190,1,0,151,0,-151
2191,1,1,868,1274,406
2192,0,0,114,0,-114
2193,0,0,38,0,-38
2194,0,0,19,0,-19
2195,0,0,20,0,-20
2196,0,0,23,0,-23
2197,0,0,63,0,-63
2198,0,0,9,0,-9
2199,1,1,396,1225,829
2200,1,1,64,1969,1905
2201,1,1,263,1240,977
2202,1,0,114,0,-114
2203,0,0,59,0,-59
2204,1,1,57,1984,1927
2205,1,1,257,3785,3528
2206,1,0,14,0,-14
2207,1,0,83,0,-83
2208,0,0,129,0,-129
2209,1,1,76,1705,1629
2210,1,0,88,0,-88
2211,1,1,1278,1808,530
2212,1,0,37,0,-37
2213,0,0,26,0,-26
2214,1,0,13,0,-13
2215,1,0,86,0,-86
2216,1,1,479,1358,879
2217,1,1,93,1211,1118
2218,1,1,2172,1362,-810
2219,0,0,11,0,-11
2220,0,0,32,0,-32
2221,0,0,15,0,-15
2222,0,0,80,0,-80
2223,0,0,39,0,-39
2224,1,1,730,1238,508
2225,0,0,16,0,-16
2226,0,0,16,0,-16
2227,1,1,120,2060,1940
2228,0,0,62,0,-62
2229,1,1,263,1673,1410
2230,1,0,36,0,-36
2231,1,0,47,0,-47
2232,0,0,10,0,-10
2233,0,0,85,0,-85
2234,1,0,14,0,-14
2235,0,0,71,0,-71
2236,1,0,91,0,-91
2237,1,1,224,1704,1480
2238,0,0,27,0,-27
2239,1,1,474,1544,1070
2240,1,1,786,2082,1296
2241,0,0,163,0,-163
2242,1,1,646,1374,728
2243,0,0,54,0,-54
2244,1,1,353,1863,1510
2245,0,0,91,0,-91
2246,1,0,31,0,-31
2247,0,0,7,0,-7
2248,1,0,37,0,-37
2249,1,1,31,1371,1340
2250,0,0,47,0,-47
2251,0,0,98,0,-98
2252,0,0,100,0,-100
2253,0,0,48,0,-48
2254,0,0,44,0,-44
2255,0,0,22,0,-22
2256,1,1,33,1319,1286
2257,1,0,4,0,-4
2258,1,0,75,0,-75
2259,0,0,52,0,-52
2260,0,0,136,0,-136
2261,0,0,0,0,0
2262,0,0,26,0,-26
2263,0,0,77,0,-77
2264,1,1,428,1298,870
2265,1,0,32,0,-32
2266,1,0,2,0,-2
2267,0,0,87,0,-87
2268,1,0,157,0,-157
2269,1,0,129,0,-129
2270,1,0,81,0,-81
2271,0,0,50,0,-50
2272,0,0,41,0,-41
2273,1,0,13,0,-13
2274,0,0,29,0,-29
2275,0,0,5,0,-5
2276,0,0,48,0,-48
2277,1,1,492,3764,3272
2278,1,0,0,0,0
2279,1,0,51,0,-51
2280,1,0,44,0,-44
2281,0,0,8,0,-8
2282,0,0,45,0,-45
2283,1,1,680,1309,629
2284,1,1,328,2038,1710
2285,0,0,73,0,-73
2286,0,0,43,0,-43
2287,0,0,2,0,-2
2288,1,1,964,1237,273
2289,0,0,18,0,-18
2290,0,0,37,0,-37
2291,1,0,25,0,-25
2292,1,0,34,0,-34
2293,0,0,61,0,-61
2294,0,0,65,0,-65
2295,0,0,9,0,-9
2296,1,0,43,0,-43
2297,1,1,829,1366,537
2298,1,0,3,0,-3
2299,1,1,1184,1922,738
2300,1,0,177,0,-177
2301,0,0,14,0,-14
2302,1,0,3,0,-3
2303,1,0,4,0,-4
2304,0,0,6,0,-6
2305,1,0,24,0,-24
2306,0,0,1,0,-1
2307,1,1,829,1642,813
2308,0,0,11,0,-11
2309,0,0,85,0,-85
2310,0,0,153,0,-153
2311,1,1,453,3629,3176
2312,1,0,11,0,-11
2313,1,1,295,1486,1191
2314,1,1,313,1739,1426
2315,0,0,46,0,-46
2316,0,0,56,0,-56
2317,0,0,53,0,-53
2318,1,1,44,1253,1209
2319,0,0,37,0,-37
2320,0,0,14,0,-14
2321,1,0,28,0,-28
2322,0,0,43,0,-43
2323,1,0,13,0,-13
2324,1,1,729,2450,1721
2325,0,0,74,0,-74
2326,0,0,138,0,-138
2327,1,0,32,0,-32
2328,1,0,69,0,-69
2329,0,0,169,0,-169
2330,0,0,60,0,-60
2331,0,0,135,0,-135
2332,1,0,72,0,-72
2333,0,0,85,0,-85
2334,1,1,277,1440,1163
2335,1,1,90,1220,1130
2336,1,0,145,0,-145
2337,0,0,45,0,-45
2338,1,0,87,0,-87
2339,0,0,19,0,-19
2340,1,1,545,1799,1254
2341,1,0,25,0,-25
2342,1,1,1046,1456,410
2343,0,0,46,0,-46
2344,1,0,6,0,-6
2345,1,1,212,1691,1479
2346,0,0,73,0,-73
2347,0,0,8,0,-8
2348,0,0,55,0,-55
2349,1,0,3,0,-3
2350,0,0,2,0,-2
2351,1,0,64,0,-64
2352,0,0,32,0,-32
2353,1,1,403,1541,1138
2354,1,0,20,0,-20
2355,1,1,1422,1884,462
2356,1,1,699,1228,529
2357,0,0,98,0,-98
2358,1,1,568,1489,921
2359,1,0,12,0,-12
2360,0,0,4,0,-4
2361,0,0,5,0,-5
2362,0,0,8,0,-8
2363,1,0,36,0,-36
2364,0,0,39,0,-39
2365,0,0,10,0,-10
2366,1,1,723,1220,497
2367,0,0,54,0,-54
2368,0,0,88,0,-88
2369,0,0,55,0,-55
2370,1,0,56,0,-56
2371,1,0,84,0,-84
2372,1,0,14,0,-14
2373,1,0,79,0,-79
2374,1,1,358,1330,972
2375,1,0,56,0,-56
2376,1,1,725,1229,504
2377,0,0,31,0,-31
2378,1,1,1110,4258,3148
2379,0,0,30,0,-30
2380,1,1,1003,1229,226
2381,1,0,14,0,-14
2382,1,0,88,0,-88
2383,0,0,18,0,-18
2384,1,0,2,0,-2
2385,0,0,4,0,-4
2386,0,0,11,0,-11
2387,0,0,18,0,-18
2388,1,1,757,1292,535
2389,1,1,167,1620,1453
2390,0,0,25,0,-25
2391,1,0,23,0,-23
2392,0,0,42,0,-42
2393,1,0,26,0,-26
2394,0,0,71,0,-71
2395,0,0,23,0,-23
2396,0,0,9,0,-9
2397,1,1,1609,1245,-364
2398,1,1,45,1445,1400
2399,0,0,71,0,-71
2400,1,0,16,0,-16
2401,1,1,305,1404,1099
2402,0,0,21,0,-21
2403,1,1,381,1332,951
2404,1,1,89,1654,1565
2405,1,1,96,1289,1193
2406,1,1,661,1373,712
2407,1,1,658,1450,792
2408,0,0,52,0,-52
2409,0,0,25,0,-25
2410,0,0,8,0,-8
2411,0,0,30,0,-30
2412,1,0,107,0,-107
2413,0,0,17,0,-17
2414,1,1,746,1395,649
2415,0,0,2,0,-2
2416,0,0,49,0,-49
2417,1,1,1334,1301,-33
2418,1,0,41,0,-41
2419,1,0,18,0,-18
2420,1,0,20,0,-20
2421,1,0,25,0,-25
2422,1,1,158,1566,1408
2423,1,0,84,0,-84
2424,1,1,372,1243,871
2425,0,0,2,0,-2
2426,0,0,12,0,-12
2427,1,0,65,0,-65
2428,0,0,10,0,-10
2429,0,0,145,0,-145
2430,1,1,490,1378,888
2431,1,0,142,0,-142
2432,1,0,13,0,-13
2433,1,1,144,2545,2401
2434,1,0,146,0,-146
2435,0,0,3,0,-3
2436,0,0,0,0,0
2437,0,0,130,0,-130
2438,0,0,38,0,-38
2439,1,0,2,0,-2
2440,1,1,28,1409,1381
2441,0,0,22,0,-22
2442,1,0,3,0,-3
2443,0,0,58,0,-58
2444,1,0,7,0,-7
2445,1,0,65,0,-65
2446,0,0,22,0,-22
2447,1,0,6,0,-6
2448,1,0,10,0,-10
2449,0,0,44,0,-44
2450,0,0,157,0,-157
2451,1,0,63,0,-63
2452,1,0,72,0,-72
2453,1,0,35,0,-35
2454,1,0,30,0,-30
2455,1,0,20,0,-20
2456,0,0,25,0,-25
2457,0,0,36,0,-36
2458,0,0,10,0,-10
2459,1,0,0,0,0
2460,0,0,23,0,-23
2461,1,0,25,0,-25
2462,0,0,2,0,-2
2463,1,0,133,0,-133
2464,1,0,110,0,-110
2465,1,1,683,1271,588
2466,1,1,651,2276,1625
2467,1,0,141,0,-141
2468,0,0,85,0,-85
2469,0,0,31,0,-31
2470,1,0,70,0,-70
2471,0,0,183,0,-183
2472,0,0,15,0,-15
2473,1,1,755,1298,543
2474,0,0,112,0,-112
2475,1,1,160,1491,1331
2476,1,0,107,0,-107
2477,1,0,33,0,-33
2478,1,0,38,0,-38
2479,0,0,22,0,-22
2480,0,0,31,0,-31
2481,1,1,177,2143,1966
2482,0,0,0,0,0
2483,1,1,340,1476,1136
2484,1,1,1294,1961,667
2485,1,0,64,0,-64
2486,0,0,83,0,-83
2487,1,1,743,1312,569
2488,1,1,254,1209,955
2489,1,0,73,0,-73
2490,1,1,538,2241,1703
2491,0,0,49,0,-49
2492,1,0,199,0,-199
2493,0,0,38,0,-38
2494,1,0,160,0,-160
2495,0,0,14,0,-14
2496,1,1,229,1760,1531
2497,0,0,73,0,-73
2498,1,1,1433,1892,459
2499,1,1,352,1818,1466
2500,0,0,39,0,-39
2501,0,0,3,0,-3
2502,1,0,172,0,-172
2503,1,1,232,1260,1028
2504,0,0,63,0,-63
2505,0,0,14,0,-14
2506,0,0,3,0,-3
2507,1,1,113,1213,1100
2508,1,0,24,0,-24
2509,1,0,28,0,-28
2510,1,0,1,0,-1
2511,1,1,419,1200,781
2512,0,0,41,0,-41
2513,1,0,3,0,-3
2514,0,0,15,0,-15
2515,0,0,67,0,-67
2516,0,0,172,0,-172
2517,0,0,7,0,-7
2518,1,0,56,0,-56
2519,1,0,19,0,-19
2520,0,0,14,0,-14
2521,1,1,131,1730,1599
2522,0,0,13,0,-13
2523,0,0,1,0,-1
2524,1,0,26,0,-26
2525,1,0,87,0,-87
2526,0,0,45,0,-45
2527,1,0,21,0,-21
2528,0,0,88,0,-88
2529,1,1,353,1395,1042
2530,0,0,204,0,-204
2531,0,0,8,0,-8
2532,1,0,17,0,-17
2533,1,0,100,0,-100
2534,1,0,5,0,-5
2535,0,0,151,0,-151
2536,0,0,0,0,0
2537,0,0,33,0,-33
2538,1,0,33,0,-33
2539,1,1,307,1256,949
2540,1,0,7,0,-7
2541,1,1,985,1310,325
2542,1,1,510,1317,807
2543,1,1,282,1346,1064
2544,0,0,64,0,-64
2545,1,0,2,0,-2
2546,1,1,37,1305,1268
2547,1,1,654,1325,671
2548,0,0,4,0,-4
2549,1,0,27,0,-27
2550,1,0,21,0,-21
2551,1,1,95,1360,1265
2552,1,1,422,1252,830
2553,1,1,1861,1278,-583
2554,1,1,389,1250,861
2555,1,0,14,0,-14
2556,0,0,20,0,-20
2557,1,1,811,1261,450
2558,1,1,1501,2157,656
2559,0,0,36,0,-36
2560,0,0,109,0,-109
2561,1,1,839,1318,479
2562,0,0,4,0,-4
2563,0,0,78,0,-78
2564,1,0,59,0,-59
2565,1,0,13,0,-13
2566,1,1,419,1783,1364
2567,0,0,253,0,-253
2568,1,0,11,0,-11
2569,1,1,296,1529,1233
2570,0,0,9,0,-9
2571,0,0,46,0,-46
2572,1,1,138,1207,1069
2573,0,0,13,0,-13
2574,1,0,55,0,-55
2575,1,0,7,0,-7
2576,1,0,26,0,-26
2577,0,0,167,0,-167
2578,1,1,451,1228,777
2579,1,0,24,0,-24
2580,1,1,759,1259,500
2581,0,0,12,0,-12
2582,0,0,7,0,-7
2583,0,0,72,0,-72
2584,1,1,402,1356,954
2585,1,1,751,1375,624
2586,1,0,5,0,-5
2587,1,1,375,1256,881
2588,1,1,2046,1295,-751
2589,0,0,263,0,-263
2590,1,0,20,0,-20
2591,1,1,158,1283,1125
2592,0,0,126,0,-126
2593,1,1,86,2066,1980
2594,0,0,15,0,-15
2595,1,0,71,0,-71
2596,1,0,1,0,-1
2597,1,1,387,2208,1821
2598,0,0,154,0,-154
2599,0,0,132,0,-132
2600,1,1,222,1343,1121
2601,0,0,64,0,-64
2602,1,1,143,1291,1148
2603,1,1,228,1430,1202
2604,0,0,36,0,-36
2605,1,0,70,0,-70
2606,0,0,58,0,-58
2607,0,0,77,0,-77
2608,1,0,84,0,-84
2609,0,0,77,0,-77
2610,1,1,407,1773,1366
2611,0,0,5,0,-5
2612,0,0,5,0,-5
2613,0,0,45,0,-45
2614,1,1,228,1492,1264
2615,0,0,20,0,-20
2616,1,1,136,2778,2642
2617,0,0,127,0,-127
2618,1,1,283,1653,1370
2619,0,0,62,0,-62
2620,1,1,116,1478,1362
2621,1,0,154,0,-154
2622,1,1,263,1272,1009
2623,1,0,26,0,-26
2624,1,0,50,0,-50
2625,1,0,88,0,-88
2626,1,1,48,1211,1163
2627,1,1,604,1556,952
2628,1,0,44,0,-44
2629,0,0,1,0,-1
2630,1,1,154,1202,1048
2631,1,1,858,1659,801
2632,1,1,301,1263,962
2633,1,0,0,0,0
2634,0,0,9,0,-9
2635,0,0,29,0,-29
2636,1,0,326,0,-326
2637,1,1,565,1383,818
2638,1,0,0,0,0
2639,0,0,72,0,-72
2640,0,0,19,0,-19
2641,1,0,150,0,-150
2642,1,1,62,1583,1521
2643,0,0,32,0,-32
2644,1,0,45,0,-45
2645,0,0,0,0,0
2646,1,0,18,0,-18
2647,0,0,36,0,-36
2648,0,0,16,0,-16
2649,1,0,41,0,-41
2650,0,0,7,0,-7
2651,0,0,10,0,-10
2652,0,0,110,0,-110
2653,1,0,29,0,-29
2654,0,0,10,0,-10
2655,1,1,1655,1200,-455
2656,1,1,312,1348,1036
2657,0,0,47,0,-47
2658,0,0,99,0,-99
2659,0,0,110,0,-110
2660,1,1,483,1239,756
2661,0,0,23,0,-23
2662,1,0,49,0,-49
2663,0,0,31,0,-31
2664,0,0,21,0,-21
2665,1,0,12,0,-12
2666,0,0,8,0,-8
2667,0,0,35,0,-35
2668,1,1,121,1232,1111
2669,0,0,16,0,-16
2670,0,0,13,0,-13
2671,0,0,0,0,0
2672,0,0,27,0,-27
2673,1,1,614,1735,1121
2674,0,0,11,0,-11
2675,0,0,4,0,-4
2676,1,1,225,3355,3130
2677,1,1,1004,2423,1419
2678,1,0,26,0,-26
2679,1,1,1183,2229,1046
2680,0,0,22,0,-22
2681,0,0,46,0,-46
2682,1,0,76,0,-76
2683,1,0,46,0,-46
2684,0,0,20,0,-20
2685,1,1,541,1456,915
2686,0,0,34,0,-34
2687,0,0,10,0,-10
2688,0,0,4,0,-4
2689,0,0,41,0,-41
2690,1,1,148,1684,1536
2691,1,1,331,1361,1030
2692,1,1,114,1490,1376
2693,1,1,119,1241,1122
2694,1,1,78,2900,2822
2695,0,0,145,0,-145
2696,0,0,3,0,-3
2697,0,0,0,0,0
2698,0,0,68,0,-68
2699,0,0,27,0,-27
2700,0,0,2,0,-2
2701,1,1,571,2303,1732
2702,1,1,271,1749,1478
2703,1,1,313,1245,932
2704,1,1,94,1332,1238
2705,1,0,38,0,-38
2706,1,0,68,0,-68
2707,1,1,325,1726,1401
2708,1,0,4,0,-4
2709,1,1,202,1390,1188
2710,1,1,251,1624,1373
2711,1,1,491,1221,730
2712,1,0,9,0,-9
2713,0,0,39,0,-39
2714,1,0,140,0,-140
2715,0,0,32,0,-32
2716,0,0,73,0,-73
2717,0,0,48,0,-48
2718,1,0,10,0,-10
2719,1,0,10,0,-10
2720,1,1,1732,1524,-208
2721,1,0,33,0,-33
2722,0,0,109,0,-109
2723,1,1,258,1652,1394
2724,1,1,256,1509,1253
2725,0,0,74,0,-74
2726,0,0,3,0,-3
2727,1,1,35,1533,1498
2728,0,0,224,0,-224
2729,1,1,134,1562,1428
2730,1,1,60,1823,1763
2731,1,0,46,0,-46
2732,1,0,105,0,-105
2733,0,0,120,0,-120
2734,0,0,76,0,-76
2735,0,0,21,0,-21
2736,1,1,339,1996,1657
2737,1,1,482,1477,995
2738,1,0,1,0,-1
2739,1,1,193,1344,1151
2740,1,0,92,0,-92
2741,1,0,118,0,-118
2742,1,0,18,0,-18
2743,0,0,4,0,-4
2744,1,1,100,2157,2057
2745,1,0,15,0,-15
2746,0,0,69,0,-69
2747,0,0,96,0,-96
2748,1,0,4,0,-4
2749,1,0,1,0,-1
2750,0,0,2,0,-2
2751,0,0,3,0,-3
2752,0,0,13,0,-13
2753,1,1,360,1419,1059
2754,1,0,30,0,-30
2755,0,0,8,0,-8
2756,0,0,31,0,-31
2757,0,0,83,0,-83
2758,1,0,67,0,-67
2759,1,1,771,1317,546
2760,1,1,538,1208,670
2761,1,1,250,1501,1251
2762,0,0,9,0,-9
2763,1,1,363,1858,1495
2764,1,1,197,1606,1409
2765,0,0,5,0,-5
2766,1,1,1341,1357,16
2767,1,1,844,1300,456
2768,1,0,3,0,-3
2769,0,0,25,0,-25
2770,0,0,45,0,-45
2771,1,1,458,1583,1125
2772,1,1,139,1221,1082
2773,1,0,17,0,-17
2774,1,0,39,0,-39
2775,1,1,709,1200,491
2776,0,0,7,0,-7
2777,0,0,18,0,-18
2778,1,0,39,0,-39
2779,1,1,816,1371,555
2780,1,1,2253,1520,-733
2781,1,0,45,0,-45
2782,0,0,22,0,-22
2783,1,1,1573,2202,629
2784,1,0,6,0,-6
2785,0,0,24,0,-24
2786,1,0,16,0,-16
2787,0,0,24,0,-24
2788,1,0,210,0,-210
2789,1,1,240,1280,1040
2790,0,0,20,0,-20
2791,1,1,276,2476,2200
2792,1,1,563,1388,825
2793,0,0,176,0,-176
2794,1,1,1246,1214,-32
2795,1,0,56,0,-56
2796,1,1,235,1356,1121
2797,0,0,131,0,-131
2798,0,0,5,0,-5
2799,1,1,262,1214,952
2800,0,0,16,0,-16
2801,0,0,117,0,-117
2802,0,0,2,0,-2
2803,1,1,829,1800,971
2804,0,0,5,0,-5
2805,1,0,41,0,-41
2806,1,1,61,1516,1455
2807,1,0,34,0,-34
2808,1,1,293,1245,952
2809,1,1,388,1264,876
2810,1,1,81,1288,1207
2811,1,1,992,2232,1240
2812,1,0,52,0,-52
2813,0,0,23,0,-23
2814,0,0,4,0,-4
2815,0,0,62,0,-62
2816,1,1,1081,1529,448
2817,1,1,1803,1274,-529
2818,0,0,0,0,0
2819,0,0,15,0,-15
2820,1,0,31,0,-31
2821,0,0,40,0,-40
2822,1,0,6,0,-6
2823,0,0,32,0,-32
2824,0,0,37,0,-37
2825,1,0,137,0,-137
2826,1,1,1038,1414,376
2827,1,1,239,1243,1004
2828,1,1,1476,2036,560
2829,1,0,18,0,-18
2830,0,0,57,0,-57
2831,0,0,8,0,-8
2832,0,0,42,0,-42
2833,1,0,32,0,-32
2834,1,1,358,2221,1863
2835,1,0,156,0,-156
2836,1,0,134,0,-134
2837,1,1,104,2154,2050
2838,1,1,1730,1888,158
2839,0,0,3,0,-3
2840,1,0,46,0,-46
2841,1,0,81,0,-81
2842,1,1,284,1466,1182
2843,1,1,430,1255,825
2844,0,0,23,0,-23
2845,0,0,7,0,-7
2846,1,1,306,1254,948
2847,0,0,40,0,-40
2848,0,0,33,0,-33
2849,0,0,2,0,-2
2850,1,0,222,0,-222
2851,0,0,119,0,-119
2852,1,0,7,0,-7
2853,0,0,27,0,-27
2854,1,0,77,0,-77
2855,1,1,185,1374,1189
2856,1,1,1549,1548,-1
2857,1,1,139,2359,2220
2858,1,0,22,0,-22
2859,0,0,45,0,-45
2860,1,1,484,1261,777
2861,0,0,9,0,-9
2862,0,0,5,0,-5
2863,1,0,19,0,-19
2864,0,0,71,0,-71
2865,1,0,14,0,-14
2866,0,0,31,0,-31
2867,1,0,109,0,-109
2868,1,1,893,1442,549
2869,1,0,166,0,-166
2870,1,0,10,0,-10
2871,0,0,68,0,-68
2872,0,0,126,0,-126
2873,1,0,71,0,-71
2874,0,0,22,0,-22
2875,1,1,602,1268,666
2876,1,1,734,1465,731
2877,0,0,2,0,-2
2878,1,0,62,0,-62
2879,1,0,25,0,-25
2880,0,0,19,0,-19
2881,0,0,53,0,-53
2882,0,0,29,0,-29
2883,0,0,6,0,-6
2884,1,0,49,0,-49
2885,1,0,158,0,-158
2886,1,1,716,1587,871
2887,1,1,175,1810,1635
2888,0,0,47,0,-47
2889,0,0,78,0,-78
2890,0,0,166,0,-166
2891,1,0,64,0,-64
2892,0,0,30,0,-30
2893,0,0,15,0,-15
2894,0,0,35,0,-35
2895,1,1,440,1324,884
2896,0,0,7,0,-7
2897,1,1,682,1835,1153
2898,1,1,550,1554,1004
2899,0,0,13,0,-13
2900,1,1,290,1314,1024
2901,0,0,34,0,-34
2902,0,0,25,0,-25
2903,0,0,4,0,-4
2904,1,1,156,1214,1058
2905,0,0,3,0,-3
2906,1,1,162,1322,1160
2907,1,1,237,1383,1146
2908,1,0,23,0,-23
2909,0,0,8,0,-8
2910,1,0,49,0,-49
2911,0,0,2,0,-2
2912,1,0,30,0,-30
2913,1,0,4,0,-4
2914,1,1,74,1344,1270
2915,0,0,38,0,-38
2916,0,0,115,0,-115
2917,0,0,27,0,-27
2918,1,1,1437,1235,-202
2919,1,1,586,1531,945
2920,1,0,19,0,-19
2921,0,0,9,0,-9
2922,0,0,101,0,-101
2923,1,0,72,0,-72
2924,1,0,24,0,-24
2925,0,0,0,0,0
2926,1,1,653,1461,808
2927,0,0,67,0,-67
2928,1,1,414,1382,968
2929,1,0,73,0,-73
2930,0,0,75,0,-75
2931,1,0,22,0,-22
2932,1,1,954,2462,1508
2933,0,0,50,0,-50
2934,1,1,374,2630,2256
2935,0,0,285,0,-285
2936,1,1,992,1213,221
2937,0,0,30,0,-30
2938,1,0,5,0,-5
2939,1,1,1458,1224,-234
2940,0,0,8,0,-8
2941,1,1,178,1380,1202
2942,0,0,28,0,-28
2943,1,0,58,0,-58
2944,0,0,2,0,-2
2945,1,1,866,1561,695
2946,1,1,141,1410,1269
2947,0,0,42,0,-42
2948,0,0,10,0,-10
2949,1,0,1,0,-1
2950,1,1,41,3249,3208
2951,0,0,59,0,-59
2952,1,0,15,0,-15
2953,0,0,30,0,-30
2954,0,0,0,0,0
2955,1,0,2,0,-2
2956,0,0,57,0,-57
2957,1,1,653,1569,916
2958,1,1,133,1414,1281
2959,1,1,296,1632,1336
2960,0,0,3,0,-3
2961,1,1,16,1477,1461
2962,1,0,92,0,-92
2963,0,0,1,0,-1
2964,0,0,40,0,-40
2965,1,1,1613,1226,-387
2966,1,1,152,1201,1049
2967,1,0,30,0,-30
2968,1,0,1,0,-1
2969,0,0,3,0,-3
2970,1,1,452,1315,863
2971,1,1,239,1978,1739
2972,0,0,45,0,-45
2973,1,0,30,0,-30
2974,0,0,48,0,-48
2975,0,0,93,0,-93
2976,1,0,18,0,-18
2977,0,0,102,0,-102
2978,1,1,309,1225,916
2979,1,1,460,1904,1444
2980,1,0,254,0,-254
2981,1,1,239,1530,1291
2982,1,1,1247,1667,420
2983,0,0,33,0,-33
2984,0,0,42,0,-42
2985,1,0,4,0,-4
2986,0,0,11,0,-11
2987,1,1,233,1733,1500
2988,1,0,78,0,-78
2989,0,0,74,0,-74
2990,1,1,13,2832,2819
2991,1,1,259,1253,994
2992,1,0,49,0,-49
2993,0,0,10,0,-10
2994,0,0,34,0,-34
2995,1,1,950,1347,397
2996,0,0,1,0,-1
2997,0,0,15,0,-15
2998,0,0,102,0,-102
2999,1,1,365,1349,984
3000,1,1,1164,1927,763
3001,0,0,47,0,-47
3002,0,0,122,0,-122
3003,0,0,178,0,-178
3004,1,1,136,1790,1654
3005,0,0,0,0,0
3006,1,1,1326,1469,143
3007,1,0,31,0,-31
3008,0,0,4,0,-4
3009,0,0,46,0,-46
3010,1,0,43,0,-43
3011,1,0,0,0,0
3012,0,0,10,0,-10
3013,0,0,124,0,-124
3014,0,0,13,0,-13
3015,1,0,135,0,-135
3016,1,0,15,0,-15
3017,0,0,0,0,0
3018,1,1,309,1455,1146
3019,1,0,10,0,-10
3020,0,0,3,0,-3
3021,1,0,34,0,-34
3022,0,0,70,0,-70
3023,0,0,45,0,-45
3024,1,1,611,1474,863
3025,1,0,30,0,-30
3026,1,1,149,2663,2514
3027,1,1,442,1640,1198
3028,1,0,48,0,-48
3029,0,0,34,0,-34
3030,1,1,595,1316,721
3031,1,1,269,1356,1087
3032,1,1,316,1436,1120
3033,1,0,35,0,-35
3034,1,0,46,0,-46
3035,0,0,104,0,-104
3036,1,1,106,1401,1295
3037,1,1,227,2113,1886
3038,1,1,287,1781,1494
3039,1,0,1,0,-1
3040,0,0,80,0,-80
3041,0,0,60,0,-60
3042,0,0,26,0,-26
3043,0,0,109,0,-109
3044,0,0,43,0,-43
3045,1,1,211,2040,1829
3046,1,0,0,0,0
3047,1,0,14,0,-14
3048,1,1,703,1458,755
3049,0,0,127,0,-127
3050,1,0,10,0,-10
3051,1,1,268,2292,2024
3052,1,0,33,0,-33
3053,1,1,112,1551,1439
3054,1,0,38,0,-38
3055,0,0,20,0,-20
3056,0,0,35,0,-35
3057,1,0,19,0,-19
3058,1,1,307,1583,1276
3059,1,1,1491,1284,-207
3060,1,1,353,1247,894
3061,0,0,113,0,-113
3062,1,0,45,0,-45
3063,1,0,63,0,-63
3064,1,0,2,0,-2
3065,1,0,56,0,-56
3066,1,1,416,1971,1555
3067,0,0,58,0,-58
3068,0,0,12,0,-12
3069,1,0,109,0,-109
3070,1,1,917,1208,291
3071,0,0,14,0,-14
3072,1,0,62,0,-62
3073,1,1,471,1332,861
3074,0,0,84,0,-84
3075,1,1,60,1485,1425
3076,1,0,39,0,-39
3077,1,1,68,1646,1578
3078,1,1,191,1240,1049
3079,0,0,8,0,-8
3080,1,0,59,0,-59
3081,1,1,1594,1229,-365
3082,1,1,98,1512,1414
3083,1,0,101,0,-101
3084,1,1,184,1318,1134
3085,0,0,73,0,-73
3086,1,1,131,1536,1405
3087,1,0,33,0,-33
3088,0,0,86,0,-86
3089,1,0,42,0,-42
3090,1,0,45,0,-45
3091,1,1,384,1473,1089
3092,1,1,267,1555,1288
3093,1,1,197,1405,1208
3094,1,1,29,1293,1264
3095,1,1,727,1222,495
3096,1,1,571,1280,709
3097,1,1,407,1662,1255
3098,1,0,45,0,-45
3099,0,0,60,0,-60
3100,1,1,63,1269,1206
3101,0,0,169,0,-169
3102,1,1,141,1400,1259
3103,1,1,379,1714,1335
3104,0,0,32,0,-32
3105,0,0,12,0,-12
3106,1,1,687,1636,949
3107,1,0,45,0,-45
3108,1,1,1371,1924,553
3109,0,0,18,0,-18
3110,1,1,50,1314,1264
3111,0,0,64,0,-64
3112,1,1,154,1230,1076
3113,1,1,859,1242,383
3114,0,0,1,0,-1
3115,0,0,14,0,-14
3116,0,0,139,0,-139
3117,1,1,438,1210,772
3118,1,0,8,0,-8
3119,1,0,143,0,-143
3120,0,0,55,0,-55
3121,1,1,362,1514,1152
3122,1,1,676,1318,642
3123,1,1,122,2898,2776
3124,1,0,27,0,-27
3125,0,0,54,0,-54
3126,1,1,162,1785,1623
3127,1,0,57,0,-57
3128,1,0,86,0,-86
3129,1,1,171,2815,2644
3130,1,0,189,0,-189
3131,1,1,815,1313,498
3132,1,0,20,0,-20
3133,1,0,63,0,-63
3134,1,0,9,0,-9
3135,1,1,261,1339,1078
3136,1,1,45,2144,2099
3137,0,0,14,0,-14
3138,1,0,3,0,-3
3139,1,1,724,1257,533
3140,0,0,5,0,-5
3141,0,0,18,0,-18
3142,1,1,178,2154,1976
3143,1,1,285,1244,959
3144,0,0,38,0,-38
3145,0,0,48,0,-48
3146,1,1,707,1250,543
3147,0,0,25,0,-25
3148,0,0,46,0,-46
3149,1,0,15,0,-15
3150,0,0,11,0,-11
3151,1,1,389,1724,1335
3152,1,1,471,1620,1149
3153,1,0,99,0,-99
3154,1,0,8,0,-8
3155,0,0,50,0,-50
3156,0,0,36,0,-36
3157,1,0,3,0,-3
3158,1,0,29,0,-29
3159,0,0,18,0,-18
3160,1,0,109,0,-109
3161,0,0,56,0,-56
3162,0,0,27,0,-27
3163,0,0,1,0,-1
3164,1,0,28,0,-28
3165,1,0,68,0,-68
3166,1,1,1243,1507,264
3167,1,0,2,0,-2
3168,1,0,94,0,-94
3169,0,0,6,0,-6
3170,1,0,33,0,-33
3171,1,0,124,0,-124
3172,0,0,12,0,-12
3173,1,0,53,0,-53
3174,0,0,42,0,-42
3175,1,0,77,0,-77
3176,1,1,148,1275,1127
3177,1,1,5700,1508,-4192
3178,0,0,90,0,-90
3179,0,0,8,0,-8
3180,1,1,373,2364,1991
3181,0,0,5,0,-5
3182,1,1,88,1227,1139
3183,1,1,674,1421,747
3184,1,1,12,1250,1238
3185,0,0,25,0,-25
3186,1,0,271,0,-271
3187,0,0,59,0,-59
3188,0,0,24,0,-24
3189,1,0,26,0,-26
3190,1,1,310,1577,1267
3191,0,0,39,0,-39
3192,1,1,718,1234,516
3193,1,1,428,1358,930
3194,0,0,53,0,-53
3195,0,0,20,0,-20
3196,1,0,48,0,-48
3197,1,1,306,1623,1317
3198,1,1,458,1610,1152
3199,1,1,1158,1413,255
3200,1,0,61,0,-61
3201,0,0,140,0,-140
3202,0,0,19,0,-19
3203,1,0,110,0,-110
3204,0,0,26,0,-26
3205,0,0,82,0,-82
3206,0,0,29,0,-29
3207,1,0,66,0,-66
3208,0,0,3,0,-3
3209,1,0,53,0,-53
3210,1,0,96,0,-96
3211,1,1,322,2410,2088
3212,0,0,2,0,-2
3213,1,0,23,0,-23
3214,1,0,6,0,-6
3215,1,1,222,1322,1100
3216,0,0,52,0,-52
3217,0,0,4,0,-4
3218,0,0,58,0,-58
3219,0,0,108,0,-108
3220,1,0,4,0,-4
3221,0,0,30,0,-30
3222,1,0,4,0,-4
3223,1,0,54,0,-54
3224,1,0,227,0,-227
3225,0,0,49,0,-49
3226,1,0,202,0,-202
3227,0,0,148,0,-148
3228,1,1,591,2500,1909
3229,0,0,26,0,-26
3230,1,0,2,0,-2
3231,1,1,1156,1325,169
3232,1,1,778,1623,845
3233,1,0,18,0,-18
3234,1,0,89,0,-89
3235,1,1,47,1435,1388
3236,0,0,19,0,-19
3237,0,0,170,0,-170
3238,0,0,29,0,-29
3239,0,0,3,0,-3
3240,1,1,213,1309,1096
3241,1,1,385,1304,919
3242,1,0,18,0,-18
3243,1,1,12,1310,1298
3244,1,0,25,0,-25
3245,0,0,27,0,-27
3246,1,1,273,2071,1798
3247,1,0,1,0,-1
3248,0,0,9,0,-9
3249,1,0,55,0,-55
3250,0,0,211,0,-211
3251,1,0,66,0,-66
3252,1,0,51,0,-51
3253,1,0,243,0,-243
3254,1,1,78,1245,1167
3255,1,1,199,2326,2127
3256,1,1,587,1311,724
3257,0,0,31,0,-31
3258,0,0,114,0,-114
3259,0,0,90,0,-90
3260,0,0,41,0,-41
3261,1,0,2,0,-2
3262,1,0,103,0,-103
3263,1,0,2,0,-2
3264,1,0,32,0,-32
3265,1,1,210,1238,1028
3266,1,1,141,1622,1481
3267,1,1,450,1815,1365
3268,0,0,23,0,-23
3269,1,1,188,1716,1528
3270,0,0,63,0,-63
3271,1,1,1106,3239,2133
3272,1,1,1561,1220,-341
3273,1,1,69,1661,1592
3274,0,0,87,0,-87
3275,1,0,2,0,-2
3276,1,1,296,1273,977
3277,0,0,7,0,-7
3278,1,1,1452,1213,-239
3279,0,0,5,0,-5
3280,1,0,127,0,-127
3281,1,0,40,0,-40
3282,1,0,4,0,-4
3283,1,0,126,0,-126
3284,0,0,22,0,-22
3285,0,0,82,0,-82
3286,0,0,21,0,-21
3287,1,0,55,0,-55
3288,0,0,15,0,-15
3289,1,0,44,0,-44
3290,1,1,44,1378,1334
3291,1,0,85,0,-85
3292,1,1,569,1750,1181
3293,0,0,22,0,-22
3294,0,0,107,0,-107
3295,1,0,1,0,-1
3296,1,1,404,1842,1438
3297,1,1,418,2995,2577
3298,1,0,6,0,-6
3299,1,0,82,0,-82
3300,0,0,24,0,-24
3301,1,1,65,1269,1204
3302,0,0,17,0,-17
3303,0,0,81,0,-81
3304,1,1,645,1236,591
3305,1,0,16,0,-16
3306,1,1,281,1313,1032
3307,1,1,411,1446,1035
3308,1,1,899,1301,402
3309,0,0,40,0,-40
3310,1,0,81,0,-81
3311,0,0,173,0,-173
3312,1,1,306,1282,976
3313,0,0,121,0,-121
3314,1,1,2031,1605,-426
3315,1,0,27,0,-27
3316,1,0,54,0,-54
3317,0,0,191,0,-191
3318,1,1,153,1230,1077
3319,0,0,16,0,-16
3320,1,0,19,0,-19
3321,0,0,86,0,-86
3322,1,0,3,0,-3
3323,1,0,51,0,-51
3324,0,0,24,0,-24
3325,1,1,1167,1257,90
3326,1,1,173,1655,1482
3327,0,0,162,0,-162
3328,0,0,117,0,-117
3329,1,1,2586,1919,-667
3330,1,0,37,0,-37
3331,1,0,8,0,-8
3332,1,1,1126,1450,324
3333,0,0,77,0,-77
3334,0,0,5,0,-5
3335,0,0,142,0,-142
3336,0,0,1,0,-1
3337,1,0,77,0,-77
3338,1,0,37,0,-37
3339,0,0,96,0,-96
3340,1,1,417,1609,1192
3341,1,1,870,1912,1042
3342,0,0,9,0,-9
3343,1,1,190,1307,1117
3344,1,1,731,1627,896
3345,1,0,51,0,-51
3346,0,0,148,0,-148
3347,0,0,17,0,-17
3348,1,1,150,1291,1141
3349,0,0,66,0,-66
3350,0,0,32,0,-32
3351,0,0,152,0,-152
3352,1,1,40,2050,2010
3353,1,1,181,1679,1498
3354,0,0,41,0,-41
3355,1,1,963,1258,295
3356,1,0,162,0,-162
3357,1,1,300,1428,1128
3358,1,0,175,0,-175
3359,1,0,37,0,-37
3360,1,1,918,1270,352
3361,0,0,111,0,-111
3362,1,1,646,1322,676
3363,0,0,5,0,-5
3364,0,0,46,0,-46
3365,0,0,8,0,-8
3366,1,1,769,1673,904
3367,1,1,745,1302,557
3368,1,1,621,1990,1369
3369,1,1,2031,1743,-288
3370,0,0,16,0,-16
3371,1,1,962,1481,519
3372,0,0,74,0,-74
3373,0,0,9,0,-9
3374,0,0,6,0,-6
3375,1,1,543,1208,665
3376,0,0,33,0,-33
3377,1,0,26,0,-26
3378,0,0,124,0,-124
3379,0,0,24,0,-24
3380,1,0,85,0,-85
3381,0,0,82,0,-82
3382,1,0,80,0,-80
3383,1,0,102,0,-102
3384,1,0,85,0,-85
3385,0,0,31,0,-31
3386,1,1,257,1447,1190
3387,0,0,13,0,-13
3388,1,0,197,0,-197
3389,1,1,253,3482,3229
3390,0,0,145,0,-145
3391,1,0,47,0,-47
3392,1,1,701,2356,1655
3393,0,0,27,0,-27
3394,0,0,2,0,-2
3395,1,1,807,1375,568
3396,1,0,78,0,-78
3397,1,1,631,1429,798
3398,0,0,34,0,-34
3399,1,1,528,1280,752
3400,1,0,0,0,0
3401,0,0,36,0,-36
3402,0,0,49,0,-49
3403,0,0,156,0,-156
3404,1,1,1409,1608,199
3405,0,0,64,0,-64
3406,0,0,12,0,-12
3407,0,0,52,0,-52
3408,0,0,0,0,0
3409,0,0,31,0,-31
3410,0,0,145,0,-145
3411,1,1,679,1290,611
3412,1,1,1114,1479,365
3413,0,0,25,0,-25
3414,0,0,93,0,-93
3415,1,0,20,0,-20
3416,1,1,570,1473,903
3417,1,1,216,1291,1075
3418,1,1,601,1424,823
3419,0,0,3,0,-3
3420,1,1,274,1373,1099
3421,0,0,185,0,-185
3422,1,0,13,0,-13
3423,0,0,26,0,-26
3424,1,1,290,1230,940
3425,0,0,25,0,-25
3426,1,0,41,0,-41
3427,0,0,86,0,-86
3428,1,0,67,0,-67
3429,0,0,64,0,-64
3430,0,0,21,0,-21
3431,1,1,810,2130,1320
3432,1,0,47,0,-47
3433,0,0,20,0,-20
3434,1,0,103,0,-103
3435,1,0,29,0,-29
3436,1,0,9,0,-9
3437,1,1,130,1239,1109
3438,0,0,12,0,-12
3439,0,0,216,0,-216
3440,0,0,74,0,-74
3441,1,0,17,0,-17
3442,1,1,746,2114,1368
3443,1,0,134,0,-134
3444,0,0,71,0,-71
3445,0,0,12,0,-12
3446,1,0,33,0,-33
3447,1,1,796,1221,425
3448,1,1,99,1585,1486
3449,1,1,326,1615,1289
3450,1,0,93,0,-93
3451,1,0,1,0,-1
3452,1,1,317,1245,928
3453,0,0,4,0,-4
3454,1,0,25,0,-25
3455,1,1,2019,1311,-708
3456,1,0,35,0,-35
3457,0,0,120,0,-120
3458,0,0,73,0,-73
3459,0,0,115,0,-115
3460,1,0,4,0,-4
3461,1,1,469,1221,752
3462,1,0,72,0,-72
3463,0,0,40,0,-40
3464,0,0,22,0,-22
3465,1,1,241,1672,1431
3466,1,1,53,1387,1334
3467,1,1,325,1244,919
3468,0,0,15,0,-15
3469,1,0,88,0,-88
3470,1,0,84,0,-84
3471,0,0,113,0,-113
3472,0,0,15,0,-15
3473,0,0,64,0,-64
3474,1,0,47,0,-47
3475,1,1,70,1410,1340
3476,1,1,471,1677,1206
3477,1,1,333,1745,1412
3478,0,0,20,0,-20
3479,1,0,24,0,-24
3480,0,0,4,0,-4
3481,1,1,661,1343,682
3482,1,1,183,1660,1477
3483,1,0,49,0,-49
3484,1,0,11,0,-11
3485,1,1,403,1227,824
3486,1,1,661,1834,1173
3487,0,0,1,0,-1
3488,0,0,43,0,-43
3489,0,0,96,0,-96
3490,0,0,16,0,-16
3491,0,0,43,0,-43
3492,1,0,4,0,-4
3493,1,0,61,0,-61
3494,0,0,0,0,0
3495,1,1,1064,1245,181
3496,1,1,343,1640,1297
3497,1,1,101,1332,1231
3498,1,0,159,0,-159
3499,1,1,63,1340,1277
3500,0,0,72,0,-72
3501,0,0,41,0,-41
3502,0,0,1,0,-1
3503,0,0,72,0,-72
3504,0,0,134,0,-134
3505,1,0,40,0,-40
3506,1,1,300,1532,1232
3507,1,0,6,0,-6
3508,0,0,1,0,-1
3509,0,0,74,0,-74
3510,1,1,485,1909,1424
3511,1,1,172,1292,1120
3512,1,1,686,1319,633
3513,1,0,18,0,-18
3514,1,1,92,1227,1135
3515,1,0,58,0,-58
3516,1,1,1039,1445,406
3517,0,0,62,0,-62
3518,1,0,25,0,-25
3519,0,0,19,0,-19
3520,0,0,0,0,0
3521,0,0,28,0,-28
3522,0,0,113,0,-113
3523,0,0,89,0,-89
3524,0,0,29,0,-29
3525,1,1,702,1383,681
3526,0,0,22,0,-22
3527,1,1,154,1458,1304
3528,1,0,34,0,-34
3529,0,0,25,0,-25
3530,1,1,1427,1391,-36
3531,1,1,641,1282,641
3532,0,0,12,0,-12
3533,1,0,85,0,-85
3534,0,0,88,0,-88
3535,0,0,11,0,-11
3536,0,0,65,0,-65
3537,1,0,28,0,-28
3538,1,0,44,0,-44
3539,0,0,25,0,-25
3540,1,1,1090,1342,252
3541,0,0,33,0,-33
3542,0,0,5,0,-5
3543,1,0,48,0,-48
3544,0,0,19,0,-19
3545,1,1,380,1591,1211
3546,1,0,39,0,-39
3547,1,0,90,0,-90
3548,1,1,231,1207,976
3549,1,0,73,0,-73
3550,1,0,75,0,-75
3551,0,0,27,0,-27
3552,1,1,198,1553,1355
3553,1,0,5,0,-5
3554,1,0,14,0,-14
3555,1,1,158,1368,1210
3556,1,0,33,0,-33
3557,0,0,66,0,-66
3558,0,0,36,0,-36
3559,0,0,91,0,-91
3560,0,0,173,0,-173
3561,1,1,291,1350,1059
3562,1,1,127,1273,1146
3563,1,0,3,0,-3
3564,1,0,1,0,-1
3565,1,0,39,0,-39
3566,1,1,831,1434,603
3567,0,0,47,0,-47
3568,1,1,846,1543,697
3569,0,0,101,0,-101
3570,0,0,85,0,-85
3571,0,0,39,0,-39
3572,1,0,34,0,-34
3573,1,0,49,0,-49
3574,1,1,627,1328,701
3575,1,1,1609,1473,-136
3576,0,0,14,0,-14
3577,1,1,207,1205,998
3578,1,0,76,0,-76
3579,1,1,682,1220,538
3580,0,0,36,0,-36
3581,1,0,24,0,-24
3582,0,0,6,0,-6
3583,0,0,123,0,-123
3584,0,0,115,0,-115
3585,0,0,22,0,-22
3586,0,0,60,0,-60
3587,1,0,15,0,-15
3588,1,0,51,0,-51
3589,1,0,90,0,-90
3590,1,1,563,1338,775
3591,1,1,380,1513,1133
3592,1,1,1755,1215,-540
3593,1,1,339,1475,1136
3594,0,0,29,0,-29
3595,1,0,57,0,-57
3596,0,0,170,0,-170
3597,0,0,109,0,-109
3598,0,0,63,0,-63
3599,0,0,42,0,-42
3600,0,0,87,0,-87
3601,1,0,7,0,-7
3602,0,0,24,0,-24
3603,0,0,17,0,-17
3604,0,0,24,0,-24
3605,1,1,418,1494,1076
3606,0,0,60,0,-60
3607,0,0,43,0,-43
3608,0,0,65,0,-65
3609,1,0,119,0,-119
3610,0,0,42,0,-42
3611,0,0,268,0,-268
3612,0,0,15,0,-15
3613,1,0,0,0,0
3614,1,0,46,0,-46
3615,1,0,27,0,-27
3616,1,1,103,1334,1231
3617,0,0,245,0,-245
3618,0,0,14,0,-14
3619,1,0,14,0,-14
3620,1,0,7,0,-7
3621,1,0,11,0,-11
3622,0,0,77,0,-77
3623,1,0,19,0,-19
3624,1,1,153,1245,1092
3625,1,1,147,5239,5092
3626,1,1,811,1210,399
3627,1,1,95,1257,1162
3628,0,0,75,0,-75
3629,0,0,7,0,-7
3630,1,1,468,1268,800
3631,1,0,146,0,-146
3632,1,1,690,1995,1305
3633,1,1,692,1241,549
3634,0,0,42,0,-42
3635,1,1,1359,1322,-37
3636,1,0,56,0,-56
3637,0,0,1,0,-1
3638,1,1,77,1202,1125
3639,1,1,649,1265,616
3640,1,0,52,0,-52
3641,1,0,90,0,-90
3642,0,0,53,0,-53
3643,1,1,28,1265,1237
3644,1,0,55,0,-55
3645,0,0,142,0,-142
3646,0,0,16,0,-16
3647,0,0,18,0,-18
3648,1,0,59,0,-59
3649,1,0,74,0,-74
3650,1,1,411,1474,1063
3651,0,0,72,0,-72
3652,1,0,125,0,-125
3653,1,0,59,0,-59
3654,0,0,85,0,-85
3655,1,1,811,1878,1067
3656,0,0,40,0,-40
3657,1,1,165,2022,1857
3658,0,0,17,0,-17
3659,1,0,4,0,-4
3660,1,1,634,1651,1017
3661,1,1,1345,1292,-53
3662,1,1,51,1247,1196
3663,1,1,240,1248,1008
3664,1,0,9,0,-9
3665,0,0,30,0,-30
3666,0,0,25,0,-25
3667,0,0,60,0,-60
3668,0,0,33,0,-33
3669,0,0,18,0,-18
3670,1,1,1227,1273,46
3671,1,1,229,1217,988
3672,1,0,138,0,-138
3673,1,0,84,0,-84
3674,0,0,111,0,-111
3675,0,0,42,0,-42
3676,1,1,42,1614,1572
3677,0,0,10,0,-10
3678,1,0,24,0,-24
3679,1,1,267,1528,1261
3680,1,0,8,0,-8
3681,1,0,85,0,-85
3682,0,0,34,0,-34
3683,0,0,28,0,-28
3684,1,1,62,1246,1184
3685,0,0,6,0,-6
3686,1,0,48,0,-48
3687,1,0,102,0,-102
3688,1,0,31,0,-31
3689,1,1,194,1358,1164
3690,1,1,819,1463,644
3691,1,1,351,1353,1002
3692,1,1,256,1499,1243
3693,1,0,3,0,-3
3694,1,1,1284,1834,550
3695,0,0,2,0,-2
3696,0,0,12,0,-12
3697,1,1,329,2618,2289
3698,1,1,889,1347,458
3699,1,1,191,1214,1023
3700,1,1,266,1274,1008
3701,0,0,32,0,-32
3702,0,0,87,0,-87
3703,1,1,245,1431,1186
3704,1,0,2,0,-2
3705,0,0,22,0,-22
3706,0,0,34,0,-34
3707,0,0,35,0,-35
3708,0,0,1,0,-1
3709,0,0,67,0,-67
3710,1,0,71,0,-71
3711,1,1,488,1977,1489
3712,1,0,49,0,-49
3713,0,0,5,0,-5
3714,1,0,8,0,-8
3715,0,0,6,0,-6
3716,1,1,1247,1488,241
3717,1,1,453,1382,929
3718,1,0,25,0,-25
3719,1,1,193,1297,1104
3720,1,0,29,0,-29
3721,0,0,134,0,-134
3722,0,0,132,0,-132
3723,0,0,31,0,-31
3724,0,0,202,0,-202
3725,1,0,63,0,-63
3726,1,1,1680,1755,75
3727,0,0,42,0,-42
3728,1,0,20,0,-20
3729,1,0,88,0,-88
3730,0,0,80,0,-80
3731,1,0,28,0,-28
3732,1,0,154,0,-154
3733,0,0,31,0,-31
3734,1,0,47,0,-47
3735,1,0,26,0,-26
3736,0,0,58,0,-58
3737,1,1,56,1333,1277
3738,1,0,66,0,-66
3739,0,0,55,0,-55
3740,0,0,89,0,-89
3741,1,1,1335,1598,263
3742,0,0,43,0,-43
3743,0,0,11,0,-11
3744,0,0,14,0,-14
3745,0,0,10,0,-10
3746,1,0,42,0,-42
3747,1,1,450,1784,1334
3748,1,0,81,0,-81
3749,1,0,95,0,-95
3750,1,1,802,1275,473
3751,1,0,126,0,-126
3752,1,1,276,2250,1974
3753,1,1,1207,2150,943
3754,1,0,7,0,-7
3755,1,0,36,0,-36
3756,0,0,31,0,-31
3757,1,0,6,0,-6
3758,0,0,34,0,-34
3759,0,0,65,0,-65
3760,1,0,76,0,-76
3761,1,1,1233,1557,324
3762,1,0,30,0,-30
3763,1,0,14,0,-14
3764,1,0,11,0,-11
3765,1,0,28,0,-28
3766,0,0,132,0,-132
3767,0,0,41,0,-41
3768,1,0,98,0,-98
3769,0,0,38,0,-38
3770,0,0,2,0,-2
3771,0,0,10,0,-10
3772,1,1,36,1260,1224
3773,1,1,625,1517,892
3774,1,1,105,2688,2583
3775,0,0,12,0,-12
3776,1,1,528,1209,681
3777,0,0,19,0,-19
3778,1,0,71,0,-71
3779,0,0,172,0,-172
3780,1,0,15,0,-15
3781,0,0,41,0,-41
3782,0,0,33,0,-33
3783,1,1,75,1411,1336
3784,1,1,359,1327,968
3785,1,1,558,1485,927
3786,0,0,42,0,-42
3787,1,1,689,1548,859
3788,1,0,8,0,-8
3789,1,1,313,1446,1133
3790,0,0,22,0,-22
3791,1,0,77,0,-77
3792,1,0,46,0,-46
3793,0,0,24,0,-24
3794,1,1,471,1557,1086
3795,1,1,566,2024,1458
3796,1,0,84,0,-84
3797,1,1,2138,1465,-673
3798,1,1,74,1201,1127
3799,0,0,60,0,-60
3800,1,0,44,0,-44
3801,1,1,1174,1576,402
3802,1,1,828,1208,380
3803,0,0,60,0,-60
3804,0,0,131,0,-131
3805,0,0,39,0,-39
3806,1,0,27,0,-27
3807,1,0,0,0,0
3808,1,0,16,0,-16
3809,1,0,120,0,-120
3810,1,1,21,1306,1285
3811,0,0,25,0,-25
3812,1,1,1255,1367,112
3813,0,0,40,0,-40
3814,1,0,4,0,-4
3815,1,1,76,1272,1196
3816,1,1,541,1255,714
3817,1,1,44,1230,1186
3818,1,0,11,0,-11
3819,0,0,21,0,-21
3820,1,0,40,0,-40
3821,0,0,24,0,-24
3822,0,0,60,0,-60
3823,0,0,4,0,-4
3824,1,1,1248,1328,80
3825,1,1,68,1599,1531
3826,1,1,3003,1674,-1329
3827,0,0,64,0,-64
3828,1,1,1202,1269,67
3829,0,0,110,0,-110
3830,1,1,113,1661,1548
3831,1,1,215,1382,1167
3832,0,0,91,0,-91
3833,0,0,14,0,-14
3834,0,0,64,0,-64
3835,0,0,50,0,-50
3836,1,1,487,1434,947
3837,0,0,36,0,-36
3838,1,1,1274,1230,-44
3839,0,0,42,0,-42
3840,0,0,27,0,-27
3841,0,0,81,0,-81
3842,0,0,12,0,-12
3843,0,0,117,0,-117
3844,0,0,160,0,-160
3845,1,0,11,0,-11
3846,0,0,14,0,-14
3847,1,1,156,2171,2015
3848,1,1,92,2375,2283
3849,1,0,53,0,-53
3850,1,1,55,1704,1649
3851,0,0,57,0,-57
3852,1,1,341,1248,907
3853,0,0,26,0,-26
3854,0,0,123,0,-123
3855,1,0,2,0,-2
3856,1,0,20,0,-20
3857,0,0,3,0,-3
3858,0,0,37,0,-37
3859,0,0,56,0,-56
3860,1,1,257,1583,1326
3861,0,0,3,0,-3
3862,1,1,471,3004,2533
3863,0,0,17,0,-17
3864,1,1,96,1350,1254
3865,1,1,519,1786,1267
3866,1,1,598,1281,683
3867,0,0,96,0,-96
3868,1,1,54,1336,1282
3869,1,1,570,1277,707
3870,1,0,19,0,-19
3871,0,0,26,0,-26
3872,0,0,80,0,-80
3873,0,0,30,0,-30
3874,1,1,466,1451,985
3875,1,1,41,1278,1237
3876,0,0,108,0,-108
3877,1,1,1156,1462,306
3878,1,1,328,1681,1353
3879,1,1,748,1482,734
3880,1,1,322,1362,1040
3881,1,0,78,0,-78
3882,1,1,245,1319,1074
3883,1,0,47,0,-47
3884,1,1,334,1633,1299
3885,1,1,321,1451,1130
3886,1,1,223,2268,2045
3887,1,1,559,1749,1190
3888,0,0,5,0,-5
3889,1,1,920,1403,483
3890,0,0,25,0,-25
3891,1,0,27,0,-27
3892,1,1,387,1745,1358
3893,0,0,41,0,-41
3894,0,0,102,0,-102
3895,1,1,270,2326,2056
3896,1,1,243,1315,1072
3897,0,0,13,0,-13
3898,1,1,612,1282,670
3899,1,0,68,0,-68
3900,1,0,39,0,-39
3901,0,0,6,0,-6
3902,1,0,45,0,-45
3903,1,1,327,1658,1331
3904,1,0,71,0,-71
3905,1,0,19,0,-19
3906,0,0,37,0,-37
3907,0,0,30,0,-30
3908,0,0,12,0,-12
3909,1,1,286,1419,1133
3910,1,1,147,2008,1861
3911,0,0,16,0,-16
3912,1,0,13,0,-13
3913,0,0,18,0,-18
3914,1,0,40,0,-40
3915,1,0,19,0,-19
3916,1,0,80,0,-80
3917,0,0,148,0,-148
3918,1,0,21,0,-21
3919,0,0,9,0,-9
3920,1,0,70,0,-70
3921,1,1,777,1318,541
3922,1,1,522,1546,1024
3923,0,0,67,0,-67
3924,1,0,134,0,-134
3925,0,0,53,0,-53
3926,1,0,17,0,-17
3927,0,0,75,0,-75
3928,0,0,5,0,-5
3929,0,0,76,0,-76
3930,1,1,600,2515,1915
3931,1,0,24,0,-24
3932,0,0,44,0,-44
3933,1,0,3,0,-3
3934,1,0,27,0,-27
3935,1,1,290,1685,1395
3936,1,1,148,1762,1614
3937,1,1,753,1369,616
3938,1,1,263,1231,968
3939,1,1,509,1351,842
3940,1,1,645,1594,949
3941,0,0,6,0,-6
3942,0,0,12,0,-12
3943,0,0,48,0,-48
3944,0,0,73,0,-73
3945,0,0,37,0,-37
3946,0,0,37,0,-37
3947,0,0,4,0,-4
3948,1,1,78,1265,1187
3949,0,0,75,0,-75
3950,1,1,240,1899,1659
3951,1,0,78,0,-78
3952,1,0,48,0,-48
3953,0,0,16,0,-16
3954,1,0,11,0,-11
3955,1,1,190,1498,1308
3956,1,1,1281,1513,232
3957,1,1,145,1526,1381
3958,1,0,7,0,-7
3959,0,0,56,0,-56
3960,1,1,177,2180,2003
3961,0,0,41,0,-41
3962,1,0,102,0,-102
3963,0,0,43,0,-43
3964,1,1,1361,1240,-121
3965,0,0,23,0,-23
3966,1,0,11,0,-11
3967,0,0,6,0,-6
3968,1,1,1276,1548,272
3969,1,1,346,1440,1094
3970,0,0,40,0,-40
3971,0,0,155,0,-155
3972,1,0,73,0,-73
3973,1,1,341,1213,872
3974,1,1,135,1320,1185
3975,0,0,118,0,-118
3976,1,1,191,1294,1103
3977,1,1,1693,1798,105
3978,0,0,32,0,-32
3979,0,0,46,0,-46
3980,1,1,1405,1386,-19
3981,0,0,76,0,-76
3982,1,1,127,1491,1364
3983,1,1,438,2446,2008
3984,1,0,43,0,-43
3985,1,1,1228,1409,181
3986,1,1,558,1306,748
3987,1,0,12,0,-12
3988,1,0,51,0,-51
3989,1,0,47,0,-47
3990,1,0,36,0,-36
3991,1,1,257,1453,1196
3992,0,0,4,0,-4
3993,0,0,48,0,-48
3994,1,0,24,0,-24
3995,1,1,153,1683,1530
3996,1,1,1648,1330,-318
3997,0,0,115,0,-115
3998,0,0,94,0,-94
3999,1,1,166,2515,2349
4000,1,1,405,1359,954
4001,1,1,727,1333,606
4002,0,0,56,0,-56
4003,1,0,102,0,-102
4004,0,0,105,0,-105
4005,1,1,620,1388,768
4006,1,0,114,0,-114
4007,0,0,26,0,-26
4008,0,0,71,0,-71
4009,0,0,33,0,-33
4010,0,0,81,0,-81
4011,0,0,99,0,-99
4012,0,0,22,0,-22
4013,0,0,81,0,-81
4014,0,0,19,0,-19
4015,1,1,107,2254,2147
4016,1,1,421,1523,1102
4017,0,0,60,0,-60
4018,1,0,20,0,-20
4019,1,0,39,0,-39
4020,1,1,220,1235,1015
4021,0,0,51,0,-51
4022,1,0,121,0,-121
4023,1,0,45,0,-45
4024,0,0,71,0,-71
4025,0,0,155,0,-155
4026,0,0,58,0,-58
4027,1,0,44,0,-44
4028,1,0,47,0,-47
4029,0,0,41,0,-41
4030,1,1,725,1217,492
4031,1,1,661,1358,697
4032,1,1,509,1248,739
4033,1,1,371,1589,1218
4034,0,0,61,0,-61
4035,1,1,451,1265,814
4036,1,0,34,0,-34
4037,0,0,12,0,-12
4038,1,0,2,0,-2
4039,1,0,19,0,-19
4040,1,1,1100,1842,742
4041,1,0,191,0,-191
4042,1,0,76,0,-76
4043,0,0,67,0,-67
4044,0,0,12,0,-12
4045,1,1,351,1271,920
4046,0,0,77,0,-77
4047,1,0,9,0,-9
4048,0,0,21,0,-21
4049,0,0,52,0,-52
4050,1,0,18,0,-18
4051,0,0,18,0,-18
4052,1,1,1472,1493,21
4053,0,0,7,0,-7
4054,0,0,86,0,-86
4055,1,1,1873,1359,-514
4056,1,0,20,0,-20
4057,0,0,345,0,-345
4058,0,0,35,0,-35
4059,1,1,138,1958,1820
4060,1,0,17,0,-17
4061,0,0,100,0,-100
4062,1,1,30,1497,1467
4063,1,0,78,0,-78
4064,1,0,6,0,-6
4065,0,0,153,0,-153
4066,1,0,42,0,-42
4067,1,0,75,0,-75
4068,1,0,92,0,-92
4069,1,0,10,0,-10
4070,1,1,464,1598,1134
4071,1,0,51,0,-51
4072,0,0,64,0,-64
4073,0,0,68,0,-68
4074,0,0,30,0,-30
4075,1,1,816,1899,1083
4076,1,1,606,1397,791
4077,0,0,62,0,-62
4078,0,0,41,0,-41
4079,1,1,588,2873,2285
4080,1,1,1109,1626,517
4081,1,1,467,1235,768
4082,1,1,541,1284,743
4083,0,0,69,0,-69
4084,0,0,39,0,-39
4085,1,1,265,1499,1234
4086,1,1,272,1250,978
4087,1,0,85,0,-85
4088,1,1,876,1252,376
4089,1,1,69,1354,1285
4090,1,0,44,0,-44
4091,1,1,1035,1363,328
4092,1,0,129,0,-129
4093,1,0,133,0,-133
4094,1,0,30,0,-30
4095,1,0,5,0,-5
4096,1,1,1933,2452,519
4097,0,0,25,0,-25
4098,0,0,62,0,-62
4099,1,1,540,2347,1807
4100,1,0,39,0,-39
4101,0,0,1,0,-1
4102,1,0,14,0,-14
4103,1,0,178,0,-178
4104,0,0,5,0,-5
4105,0,0,4,0,-4
4106,1,1,886,2358,1472
4107,1,1,860,1628,768
4108,0,0,25,0,-25
4109,0,0,1,0,-1
4110,1,1,117,1354,1237
4111,0,0,2,0,-2
4112,0,0,64,0,-64
4113,1,1,733,1485,752
4114,1,1,1016,1248,232
4115,1,1,318,1221,903
4116,1,0,60,0,-60
4117,1,0,33,0,-33
4118,1,0,60,0,-60
4119,0,0,17,0,-17
4120,0,0,196,0,-196
4121,1,1,1060,1443,383
4122,0,0,2,0,-2
4123,1,1,61,1505,1444
4124,0,0,19,0,-19
4125,0,0,8,0,-8
4126,1,1,107,1409,1302
4127,1,0,78,0,-78
4128,1,0,95,0,-95
4129,1,0,2,0,-2
4130,1,1,450,2209,1759
4131,1,0,16,0,-16
4132,1,0,59,0,-59
4133,1,0,9,0,-9
4134,0,0,34,0,-34
4135,1,0,71,0,-71
4136,0,0,11,0,-11
4137,1,0,2,0,-2
4138,0,0,59,0,-59
4139,1,1,629,1958,1329
4140,1,0,16,0,-16
4141,1,1,1046,1280,234
4142,0,0,33,0,-33
4143,0,0,15,0,-15
4144,0,0,10,0,-10
4145,1,1,727,1396,669
4146,0,0,62,0,-62
4147,1,0,17,0,-17
4148,0,0,37,0,-37
4149,0,0,72,0,-72
4150,1,1,145,1632,1487
4151,1,0,59,0,-59
4152,1,0,0,0,0
4153,0,0,18,0,-18
4154,0,0,17,0,-17
4155,1,1,1779,1366,-413
4156,1,0,42,0,-42
4157,1,0,1,0,-1
4158,1,0,32,0,-32
4159,0,0,47,0,-47
4160,1,1,1427,1252,-175
4161,1,0,38,0,-38
4162,1,1,277,2290,2013
4163,1,1,214,1292,1078
4164,1,1,752,1785,1033
4165,1,0,19,0,-19
4166,0,0,51,0,-51
4167,1,0,9,0,-9
4168,1,1,527,2044,1517
4169,1,0,20,0,-20
4170,1,1,237,1351,1114
4171,0,0,185,0,-185
4172,1,0,22,0,-22
4173,0,0,20,0,-20
4174,0,0,15,0,-15
4175,0,0,66,0,-66
4176,0,0,2,0,-2
4177,0,0,59,0,-59
4178,0,0,54,0,-54
4179,1,1,433,1393,960
4180,1,0,60,0,-60
4181,1,0,1,0,-1
4182,1,0,3,0,-3
4183,1,1,451,1930,1479
4184,0,0,48,0,-48
4185,0,0,69,0,-69
4186,1,0,91,0,-91
4187,0,0,90,0,-90
4188,1,1,624,1318,694
4189,1,1,210,1326,1116
4190,1,0,16,0,-16
4191,0,0,129,0,-129
4192,1,0,45,0,-45
4193,1,1,760,1206,446
4194,0,0,32,0,-32
4195,0,0,3,0,-3
4196,1,0,2,0,-2
4197,1,0,84,0,-84
4198,1,1,615,1542,927
4199,1,0,89,0,-89
4200,1,1,483,1437,954
4201,1,0,55,0,-55
4202,0,0,55,0,-55
4203,0,0,62,0,-62
4204,1,1,207,1652,1445
4205,0,0,2,0,-2
4206,1,0,33,0,-33
4207,0,0,10,0,-10
4208,1,1,673,1287,614
4209,1,0,93,0,-93
4210,1,0,83,0,-83
4211,1,1,551,1286,735
4212,0,0,46,0,-46
4213,1,0,80,0,-80
4214,0,0,3,0,-3
4215,1,0,1,0,-1
4216,0,0,52,0,-52
4217,0,0,21,0,-21
4218,0,0,9,0,-9
4219,1,1,394,1643,1249
4220,1,1,764,2431,1667
4221,0,0,49,0,-49
4222,0,0,21,0,-21
4223,1,1,576,1645,1069
4224,0,0,86,0,-86
4225,1,1,1216,1225,9
4226,0,0,12,0,-12
4227,1,0,25,0,-25
4228,0,0,37,0,-37
4229,1,1,461,2254,1793
4230,1,1,593,2239,1646
4231,1,1,55,1448,1393
4232,1,1,479,1247,768
4233,1,1,1381,1217,-164
4234,0,0,25,0,-25
4235,1,0,9,0,-9
4236,0,0,43,0,-43
4237,0,0,70,0,-70
4238,1,0,16,0,-16
4239,1,1,756,1212,456
4240,1,1,1579,1388,-191
4241,1,1,1130,1424,294
4242,1,1,1969,1698,-271
4243,1,1,353,1596,1243
4244,0,0,22,0,-22
4245,1,0,41,0,-41
4246,1,1,195,1200,1005
4247,1,0,46,0,-46
4248,0,0,93,0,-93
4249,1,1,502,1573,1071
4250,0,0,50,0,-50
4251,1,1,1137,1361,224
4252,1,0,16,0,-16
4253,0,0,6,0,-6
4254,1,1,627,2376,1749
4255,1,0,58,0,-58
4256,1,1,349,1201,852
4257,0,0,37,0,-37
4258,1,1,5,1679,1674
4259,0,0,264,0,-264
4260,0,0,13,0,-13
4261,1,1,399,1287,888
4262,0,0,41,0,-41
4263,0,0,77,0,-77
4264,1,1,351,1605,1254
4265,1,0,82,0,-82
4266,1,0,28,0,-28
4267,0,0,35,0,-35
4268,1,0,37,0,-37
4269,0,0,9,0,-9
4270,1,0,35,0,-35
4271,1,0,8,0,-8
4272,0,0,130,0,-130
4273,0,0,22,0,-22
4274,0,0,208,0,-208
4275,1,1,430,1247,817
4276,1,1,694,1776,1082
4277,1,0,5,0,-5
4278,0,0,47,0,-47
4279,0,0,120,0,-120
4280,1,0,11,0,-11
4281,0,0,12,0,-12
4282,0,0,38,0,-38
4283,1,0,31,0,-31
4284,1,0,35,0,-35
4285,0,0,13,0,-13
4286,0,0,0,0,0
4287,1,1,120,1201,1081
4288,1,0,14,0,-14
4289,1,0,68,0,-68
4290,1,1,110,1546,1436
4291,0,0,62,0,-62
4292,1,1,148,1602,1454
4293,0,0,61,0,-61
4294,1,1,627,1324,697
4295,1,0,16,0,-16
4296,0,0,50,0,-50
4297,1,0,147,0,-147
4298,1,1,665,1785,1120
4299,1,1,184,1284,1100
4300,0,0,69,0,-69
4301,0,0,5,0,-5
4302,1,0,95,0,-95
4303,0,0,27,0,-27
4304,1,1,1009,1317,308
4305,1,1,358,1221,863
4306,1,0,22,0,-22
4307,0,0,106,0,-106
4308,1,0,2,0,-2
4309,0,0,20,0,-20
4310,0,0,60,0,-60
4311,0,0,10,0,-10
4312,1,1,221,1310,1089
4313,0,0,10,0,-10
4314,0,0,35,0,-35
4315,1,0,107,0,-107
4316,1,1,219,1256,1037
4317,0,0,200,0,-200
4318,1,1,146,1447,1301
4319,1,1,1265,1212,-53
4320,1,0,2,0,-2
4321,1,1,188,1369,1181
4322,1,1,46,1207,1161
4323,0,0,4,0,-4
4324,1,1,1499,1523,24
4325,1,1,60,1314,1254
4326,0,0,20,0,-20
4327,1,0,193,0,-193
4328,1,1,104,1980,1876
4329,1,0,118,0,-118
4330,0,0,12,0,-12
4331,1,1,234,2819,2585
4332,0,0,8,0,-8
4333,0,0,62,0,-62
4334,0,0,39,0,-39
4335,0,0,10,0,-10
4336,1,0,63,0,-63
4337,1,1,32,2132,2100
4338,1,1,367,1949,1582
4339,1,0,23,0,-23
4340,0,0,47,0,-47
4341,1,0,45,0,-45
4342,1,1,311,1283,972
4343,1,1,1521,1502,-19
4344,1,1,527,1580,1053
4345,1,0,80,0,-80
4346,0,0,9,0,-9
4347,0,0,7,0,-7
4348,0,0,14,0,-14
4349,1,0,104,0,-104
4350,0,0,121,0,-121
4351,1,0,0,0,0
4352,1,1,325,2006,1681
4353,1,1,961,1226,265
4354,1,0,43,0,-43
4355,0,0,39,0,-39
4356,1,1,53,1816,1763
4357,1,1,723,1208,485
4358,1,0,0,0,0
4359,1,1,317,1236,919
4360,1,0,55,0,-55
4361,0,0,50,0,-50
4362,0,0,12,0,-12
4363,0,0,40,0,-40
4364,1,0,51,0,-51
4365,1,1,85,1354,1269
4366,1,1,136,1400,1264
4367,0,0,97,0,-97
4368,1,0,13,0,-13
4369,0,0,121,0,-121
4370,0,0,126,0,-126
4371,1,0,22,0,-22
4372,1,0,43,0,-43
4373,1,1,436,1436,1000
4374,0,0,41,0,-41
4375,0,0,5,0,-5
4376,0,0,110,0,-110
4377,1,1,82,1324,1242
4378,0,0,58,0,-58
4379,0,0,99,0,-99
4380,1,1,651,1265,614
4381,0,0,19,0,-19
4382,1,0,37,0,-37
4383,0,0,25,0,-25
4384,0,0,25,0,-25
4385,1,0,15,0,-15
4386,0,0,63,0,-63
4387,1,1,874,1315,441
4388,1,0,10,0,-10
4389,0,0,5,0,-5
4390,0,0,94,0,-94
4391,1,0,113,0,-113
4392,1,1,80,1979,1899
4393,1,0,2,0,-2
4394,1,1,65,1596,1531
4395,1,0,0,0,0
4396,0,0,161,0,-161
4397,1,1,124,1596,1472
4398,1,1,777,1688,911
4399,0,0,17,0,-17
4400,1,1,1360,2055,695
4401,0,0,9,0,-9
4402,0,0,46,0,-46
4403,1,0,101,0,-101
4404,1,1,263,1505,1242
4405,0,0,8,0,-8
4406,0,0,85,0,-85
4407,1,0,46,0,-46
4408,0,0,6,0,-6
4409,1,0,2,0,-2
4410,1,0,0,0,0
4411,1,1,482,1306,824
4412,1,0,33,0,-33
4413,0,0,155,0,-155
4414,1,1,61,3088,3027
4415,1,0,63,0,-63
4416,0,0,0,0,0
4417,1,1,577,1296,719
4418,0,0,86,0,-86
4419,0,0,54,0,-54
4420,1,1,97,1211,1114
4421,1,0,7,0,-7
4422,1,1,44,1299,1255
4423,1,0,12,0,-12
4424,1,0,21,0,-21
4425,0,0,77,0,-77
4426,0,0,1,0,-1
4427,1,0,12,0,-12
4428,0,0,28,0,-28
4429,1,0,68,0,-68
4430,0,0,38,0,-38
4431,0,0,4,0,-4
4432,1,0,5,0,-5
4433,1,1,613,1594,981
4434,1,0,129,0,-129
4435,1,1,323,1450,1127
4436,1,0,23,0,-23
4437,0,0,37,0,-37
4438,0,0,41,0,-41
4439,0,0,103,0,-103
4440,0,0,0,0,0
4441,1,0,75,0,-75
4442,0,0,53,0,-53
4443,1,0,73,0,-73
4444,0,0,33,0,-33
4445,1,0,16,0,-16
4446,1,0,5,0,-5
4447,0,0,34,0,-34
4448,1,0,40,0,-40
4449,0,0,2,0,-2
4450,1,0,73,0,-73
4451,1,0,15,0,-15
4452,1,0,91,0,-91
4453,0,0,64,0,-64
4454,1,1,1086,1643,557
4455,1,0,329,0,-329
4456,1,1,1338,3267,1929
4457,1,0,94,0,-94
4458,1,0,132,0,-132
4459,0,0,10,0,-10
4460,0,0,18,0,-18
4461,1,1,486,2398,1912
