ID,Флаг дозвона,Флаг продажи,Расходы,PV,NPV
0,1,1,541,1314,773
1,1,1,208,1654,1446
2,1,1,705,2228,1523
3,1,0,3,0,-3
4,1,1,692,1457,765
5,0,0,27,0,-27
6,0,0,21,0,-21
7,1,0,92,0,-92
8,1,0,8,0,-8
9,0,0,9,0,-9
10,1,0,78,0,-78
11,1,1,116,1429,1313
12,1,1,38,1206,1168
13,0,0,91,0,-91
14,0,0,64,0,-64
15,1,0,132,0,-132
16,0,0,16,0,-16
17,1,1,752,1405,653
18,0,0,23,0,-23
19,1,1,966,1427,461
20,0,0,183,0,-183
21,0,0,18,0,-18
22,1,1,198,1977,1779
23,1,0,16,0,-16
24,1,1,149,2109,1960
25,0,0,38,0,-38
26,1,1,251,1226,975
27,1,1,67,1201,1134
28,0,0,2,0,-2
29,1,0,6,0,-6
30,1,1,948,2267,1319
31,1,0,22,0,-22
32,1,0,71,0,-71
33,0,0,71,0,-71
34,0,0,4,0,-4
35,1,1,1021,1467,446
36,0,0,33,0,-33
37,0,0,11,0,-11
38,0,0,88,0,-88
39,1,0,67,0,-67
40,1,1,1448,1546,98
41,0,0,10,0,-10
42,1,1,183,1838,1655
43,0,0,36,0,-36
44,1,1,213,1401,1188
45,1,0,35,0,-35
46,1,1,749,2097,1348
47,1,1,3070,1525,-1545
48,1,0,2,0,-2
49,1,0,7,0,-7
50,0,0,34,0,-34
51,1,0,18,0,-18
52,1,1,1000,1433,433
53,1,0,23,0,-23
54,1,0,12,0,-12
55,1,0,6,0,-6
56,1,0,56,0,-56
57,0,0,20,0,-20
58,0,0,29,0,-29
59,1,1,268,1233,965
60,1,0,65,0,-65
61,0,0,12,0,-12
62,1,1,313,1304,991
63,0,0,0,0,0
64,1,1,97,1612,1515
65,1,0,34,0,-34
66,1,0,119,0,-119
67,0,0,6,0,-6
68,1,0,75,0,-75
69,0,0,10,0,-10
70,0,0,6,0,-6
71,1,1,132,1277,1145
72,1,1,984,1205,221
73,1,1,972,1418,446
74,1,0,37,0,-37
75,1,0,182,0,-182
76,1,0,26,0,-26
77,0,0,32,0,-32
78,1,1,123,1413,1290
79,1,0,110,0,-110
80,1,1,396,1260,864
81,1,0,33,0,-33
82,1,1,359,1660,1301
83,1,0,93,0,-93
84,1,1,172,1896,1724
85,1,1,216,1493,1277
86,1,0,22,0,-22
87,0,0,69,0,-69
88,0,0,42,0,-42
89,0,0,62,0,-62
90,1,0,62,0,-62
91,0,0,43,0,-43
92,1,1,128,1385,1257
93,1,0,22,0,-22
94,1,0,4,0,-4
95,1,1,80,1459,1379
96,1,1,265,1444,1179
97,1,1,1078,1224,146
98,1,1,933,1361,428
99,1,0,87,0,-87
100,1,0,93,0,-93
101,1,1,613,1577,964
102,1,0,26,0,-26
103,0,0,7,0,-7
104,1,1,48,1424,1376
105,1,0,1,0,-1
106,1,1,431,1969,1538
107,1,1,79,2678,2599
108,0,0,43,0,-43
109,1,1,146,1234,1088
110,1,1,1747,1518,-229
111,1,1,335,1277,942
112,0,0,136,0,-136
113,1,1,188,1481,1293
114,1,0,207,0,-207
115,0,0,72,0,-72
116,1,1,339,2816,2477
117,1,1,1110,1758,648
118,1,1,270,1339,1069
119,1,0,32,0,-32
120,0,0,25,0,-25
121,1,1,109,2237,2128
122,1,1,412,1382,970
123,1,0,17,0,-17
124,1,1,2666,1336,-1330
125,0,0,11,0,-11
126,1,1,118,1254,1136
127,1,1,709,2126,1417
128,1,1,1425,2162,737
129,1,0,35,0,-35
130,1,0,69,0,-69
131,1,0,87,0,-87
132,1,1,1326,1299,-27
133,0,0,137,0,-137
134,1,1,14,1376,1362
135,1,1,273,1301,1028
136,1,1,1140,1557,417
137,0,0,16,0,-16
138,1,0,33,0,-33
139,1,0,16,0,-16
140,0,0,95,0,-95
141,1,1,272,1251,979
142,1,0,13,0,-13
143,0,0,1,0,-1
144,1,0,27,0,-27
145,0,0,44,0,-44
146,1,0,35,0,-35
147,0,0,62,0,-62
148,0,0,13,0,-13
149,1,1,809,1605,796
150,0,0,60,0,-60
151,1,0,25,0,-25
152,0,0,90,0,-90
153,0,0,85,0,-85
154,0,0,26,0,-26
155,0,0,12,0,-12
156,0,0,5,0,-5
157,1,1,1629,1231,-398
158,1,1,125,1479,1354
159,0,0,95,0,-95
160,1,1,720,1578,858
161,1,1,408,1213,805
162,1,1,57,1312,1255
163,1,0,88,0,-88
164,1,1,512,1207,695
165,0,0,31,0,-31
166,0,0,6,0,-6
167,1,0,56,0,-56
168,1,1,90,1242,1152
169,0,0,22,0,-22
170,0,0,172,0,-172
171,0,0,23,0,-23
172,1,1,386,1663,1277
173,1,0,146,0,-146
174,1,1,113,1248,1135
175,0,0,26,0,-26
176,0,0,9,0,-9
177,1,0,58,0,-58
178,1,1,526,1925,1399
179,1,1,897,1875,978
180,0,0,43,0,-43
181,0,0,10,0,-10
182,1,0,64,0,-64
183,0,0,12,0,-12
184,0,0,27,0,-27
185,1,1,31,1273,1242
186,1,1,1337,1396,59
187,0,0,81,0,-81
188,1,0,29,0,-29
189,1,0,0,0,0
190,0,0,33,0,-33
191,0,0,21,0,-21
192,1,0,31,0,-31
193,0,0,82,0,-82
194,1,1,186,1585,1399
195,1,0,42,0,-42
196,0,0,3,0,-3
197,1,0,14,0,-14
198,0,0,61,0,-61
199,1,1,174,1503,1329
200,1,1,155,1541,1386
201,1,0,22,0,-22
202,0,0,30,0,-30
203,1,0,16,0,-16
204,0,0,27,0,-27
205,1,0,1,0,-1
206,0,0,42,0,-42
207,1,1,301,1502,1201
208,1,1,405,1310,905
209,1,1,441,1574,1133
210,0,0,15,0,-15
211,1,0,73,0,-73
212,1,0,12,0,-12
213,1,0,1,0,-1
214,1,0,70,0,-70
215,0,0,130,0,-130
216,0,0,17,0,-17
217,0,0,7,0,-7
218,0,0,128,0,-128
219,0,0,10,0,-10
220,0,0,37,0,-37
221,0,0,2,0,-2
222,1,0,90,0,-90
223,1,0,76,0,-76
224,1,1,702,1264,562
225,0,0,63,0,-63
226,1,0,117,0,-117
227,0,0,91,0,-91
228,1,1,783,1379,596
229,0,0,15,0,-15
230,1,0,8,0,-8
231,1,1,430,1507,1077
232,1,0,32,0,-32
233,1,0,48,0,-48
234,1,0,17,0,-17
235,1,0,88,0,-88
236,1,0,120,0,-120
237,0,0,9,0,-9
238,1,1,880,1249,369
239,1,1,250,1258,1008
240,0,0,61,0,-61
241,1,1,2777,1303,-1474
242,1,0,90,0,-90
243,0,0,20,0,-20
244,1,1,139,1269,1130
245,1,1,933,1215,282
246,1,1,371,1386,1015
247,1,0,42,0,-42
248,0,0,23,0,-23
249,1,0,100,0,-100
250,0,0,83,0,-83
251,1,1,152,1385,1233
252,1,0,61,0,-61
253,1,0,13,0,-13
254,1,0,4,0,-4
255,1,1,888,1317,429
256,0,0,85,0,-85
257,1,0,135,0,-135
258,0,0,9,0,-9
259,1,1,61,1269,1208
260,1,1,143,1395,1252
261,0,0,2,0,-2
262,1,0,77,0,-77
263,1,1,125,1612,1487
264,1,1,636,1204,568
265,1,1,121,2264,2143
266,1,1,344,1215,871
267,0,0,114,0,-114
268,0,0,14,0,-14
269,1,0,88,0,-88
270,1,1,196,1227,1031
271,0,0,7,0,-7
272,1,0,42,0,-42
273,1,1,215,1247,1032
274,1,1,197,2265,2068
275,1,0,61,0,-61
276,0,0,31,0,-31
277,1,1,389,1664,1275
278,1,0,3,0,-3
279,1,0,42,0,-42
280,1,1,417,1335,918
281,1,1,120,1392,1272
282,0,0,1,0,-1
283,1,0,81,0,-81
284,1,1,974,1433,459
285,1,0,38,0,-38
286,1,1,150,1202,1052
287,1,0,192,0,-192
288,1,1,237,1246,1009
289,1,1,285,1385,1100
290,0,0,68,0,-68
291,0,0,93,0,-93
292,1,1,292,1525,1233
293,1,1,255,1201,946
294,0,0,50,0,-50
295,1,1,1018,1373,355
296,0,0,34,0,-34
297,0,0,51,0,-51
298,0,0,39,0,-39
299,1,0,16,0,-16
300,0,0,33,0,-33
301,1,0,174,0,-174
302,1,0,84,0,-84
303,1,1,1076,1221,145
304,0,0,20,0,-20
305,0,0,3,0,-3
306,1,0,120,0,-120
307,1,0,26,0,-26
308,0,0,47,0,-47
309,1,1,260,1370,1110
310,0,0,21,0,-21
311,1,1,132,1216,1084
312,0,0,48,0,-48
313,1,0,41,0,-41
314,0,0,40,0,-40
315,1,0,145,0,-145
316,0,0,51,0,-51
317,1,1,312,1525,1213
318,0,0,0,0,0
319,1,1,316,1705,1389
320,1,1,449,1672,1223
321,0,0,23,0,-23
322,0,0,29,0,-29
323,1,0,1,0,-1
324,0,0,89,0,-89
325,1,1,296,1209,913
326,0,0,45,0,-45
327,1,1,130,1707,1577
328,0,0,4,0,-4
329,1,1,1893,1320,-573
330,0,0,79,0,-79
331,0,0,20,0,-20
332,1,0,17,0,-17
333,1,1,1215,1262,47
334,0,0,65,0,-65
335,1,1,271,1332,1061
336,1,0,71,0,-71
337,1,1,505,2272,1767
338,0,0,36,0,-36
339,1,1,882,1628,746
340,1,0,218,0,-218
341,0,0,41,0,-41
342,1,0,10,0,-10
343,0,0,51,0,-51
344,0,0,24,0,-24
345,1,0,101,0,-101
346,0,0,6,0,-6
347,0,0,136,0,-136
348,0,0,33,0,-33
349,1,1,453,1351,898
350,1,1,1234,1249,15
351,1,1,1570,1924,354
352,1,1,256,1203,947
353,1,0,18,0,-18
354,1,1,697,2063,1366
355,1,1,793,1293,500
356,0,0,26,0,-26
357,0,0,14,0,-14
358,0,0,26,0,-26
359,1,1,262,1887,1625
360,1,0,25,0,-25
361,0,0,8,0,-8
362,1,1,260,1568,1308
363,1,0,185,0,-185
364,0,0,87,0,-87
365,1,1,1678,1514,-164
366,1,1,465,1904,1439
367,0,0,13,0,-13
368,0,0,16,0,-16
369,0,0,82,0,-82
370,1,0,114,0,-114
371,0,0,74,0,-74
372,0,0,30,0,-30
373,1,0,102,0,-102
374,1,1,163,1280,1117
375,0,0,1,0,-1
376,0,0,30,0,-30
377,1,1,104,1396,1292
378,1,0,43,0,-43
379,0,0,25,0,-25
380,1,1,1611,1812,201
381,0,0,31,0,-31
382,0,0,98,0,-98
383,1,1,643,2034,1391
384,0,0,6,0,-6
385,0,0,49,0,-49
386,1,1,190,1247,1057
387,1,1,39,1405,1366
388,1,0,87,0,-87
389,1,0,41,0,-41
390,1,0,3,0,-3
391,0,0,38,0,-38
392,0,0,217,0,-217
393,0,0,10,0,-10
394,1,0,45,0,-45
395,1,0,221,0,-221
396,1,1,1007,1584,577
397,1,0,58,0,-58
398,0,0,17,0,-17
399,1,1,735,1362,627
400,0,0,73,0,-73
401,0,0,75,0,-75
402,1,0,5,0,-5
403,0,0,42,0,-42
404,1,0,85,0,-85
405,1,0,258,0,-258
406,0,0,23,0,-23
407,0,0,29,0,-29
408,0,0,81,0,-81
409,1,1,848,1360,512
410,0,0,28,0,-28
411,1,1,682,1326,644
412,1,1,133,1640,1507
413,1,1,382,1227,845
414,1,0,183,0,-183
415,1,1,174,1408,1234
416,0,0,228,0,-228
417,0,0,33,0,-33
418,0,0,20,0,-20
419,1,0,47,0,-47
420,1,1,285,2793,2508
421,0,0,172,0,-172
422,1,0,51,0,-51
423,1,0,1,0,-1
424,1,1,509,1287,778
425,1,0,17,0,-17
426,0,0,152,0,-152
427,1,0,64,0,-64
428,0,0,58,0,-58
429,1,0,33,0,-33
430,0,0,29,0,-29
431,0,0,50,0,-50
432,0,0,48,0,-48
433,0,0,16,0,-16
434,1,1,474,1342,868
435,0,0,24,0,-24
436,1,0,16,0,-16
437,1,1,199,1231,1032
438,1,1,284,1406,1122
439,1,0,34,0,-34
440,1,0,77,0,-77
441,0,0,44,0,-44
442,0,0,27,0,-27
443,0,0,42,0,-42
444,0,0,42,0,-42
445,1,1,354,1320,966
446,1,1,368,1879,1511
447,1,1,187,1360,1173
448,1,0,7,0,-7
449,0,0,17,0,-17
450,0,0,3,0,-3
451,0,0,154,0,-154
452,1,1,359,1704,1345
453,1,0,64,0,-64
454,0,0,150,0,-150
455,1,1,361,1666,1305
456,1,1,271,1571,1300
457,1,1,1138,1437,299
458,0,0,4,0,-4
459,0,0,5,0,-5
460,0,0,15,0,-15
461,1,0,93,0,-93
462,1,0,17,0,-17
463,0,0,14,0,-14
464,1,0,69,0,-69
465,1,0,12,0,-12
466,1,1,1592,1203,-389
467,1,1,105,1414,1309
468,1,0,109,0,-109
469,0,0,13,0,-13
470,1,0,18,0,-18
471,1,1,68,1291,1223
472,1,0,84,0,-84
473,0,0,37,0,-37
474,0,0,29,0,-29
475,0,0,193,0,-193
476,1,0,9,0,-9
477,1,0,17,0,-17
478,1,0,2,0,-2
479,0,0,90,0,-90
480,1,0,150,0,-150
481,1,1,896,1311,415
482,0,0,103,0,-103
483,0,0,94,0,-94
484,1,0,71,0,-71
485,1,1,800,1527,727
486,1,0,112,0,-112
487,1,1,174,1689,1515
488,0,0,13,0,-13
489,1,1,470,1907,1437
490,0,0,102,0,-102
491,1,1,411,1322,911
492,1,1,371,1446,1075
493,0,0,92,0,-92
494,1,0,39,0,-39
495,0,0,0,0,0
496,1,1,19,3516,3497
497,0,0,21,0,-21
498,0,0,20,0,-20
499,1,1,91,1245,1154
500,0,0,247,0,-247
501,1,1,425,1640,1215
502,1,1,269,1300,1031
503,1,0,36,0,-36
504,1,0,7,0,-7
505,0,0,41,0,-41
506,0,0,4,0,-4
507,1,0,5,0,-5
508,1,0,1,0,-1
509,0,0,17,0,-17
510,1,1,222,1381,1159
511,1,0,127,0,-127
512,1,1,953,1419,466
513,1,1,423,1215,792
514,0,0,111,0,-111
515,1,1,829,1291,462
516,0,0,3,0,-3
517,1,1,611,1890,1279
518,0,0,178,0,-178
519,1,1,346,1443,1097
520,1,0,144,0,-144
521,0,0,2,0,-2
522,1,0,47,0,-47
523,0,0,45,0,-45
524,1,0,62,0,-62
525,1,0,25,0,-25
526,1,1,206,1245,1039
527,1,1,212,2788,2576
528,1,0,16,0,-16
529,1,1,63,1203,1140
530,1,1,300,1285,985
531,0,0,14,0,-14
532,1,1,825,1755,930
533,1,1,440,1243,803
534,0,0,6,0,-6
535,0,0,26,0,-26
536,1,1,426,2586,2160
537,0,0,2,0,-2
538,0,0,112,0,-112
539,0,0,108,0,-108
540,1,0,98,0,-98
541,1,0,72,0,-72
542,1,1,1038,1211,173
543,1,1,224,1336,1112
544,1,1,608,1215,607
545,1,0,30,0,-30
546,1,0,54,0,-54
547,1,1,686,1910,1224
548,1,0,8,0,-8
549,1,0,1,0,-1
550,1,1,626,1405,779
551,0,0,92,0,-92
552,1,1,1785,1249,-536
553,1,0,14,0,-14
554,1,1,130,1784,1654
555,0,0,57,0,-57
556,1,1,554,1277,723
557,1,0,121,0,-121
558,1,1,95,1215,1120
559,0,0,132,0,-132
560,0,0,2,0,-2
561,0,0,4,0,-4
562,1,1,115,1418,1303
563,0,0,42,0,-42
564,0,0,15,0,-15
565,0,0,15,0,-15
566,0,0,153,0,-153
567,0,0,23,0,-23
568,1,0,67,0,-67
569,1,1,980,1243,263
570,1,1,708,1442,734
571,0,0,7,0,-7
572,0,0,34,0,-34
573,0,0,55,0,-55
574,1,0,43,0,-43
575,1,0,326,0,-326
576,1,1,80,1671,1591
577,1,1,264,1269,1005
578,0,0,113,0,-113
579,1,0,62,0,-62
580,1,1,774,1246,472
581,0,0,13,0,-13
582,0,0,53,0,-53
583,0,0,43,0,-43
584,0,0,195,0,-195
585,1,1,180,1318,1138
586,0,0,29,0,-29
587,1,1,350,1809,1459
588,0,0,12,0,-12
589,0,0,74,0,-74
590,1,1,54,1920,1866
591,0,0,2,0,-2
592,1,0,68,0,-68
593,0,0,15,0,-15
594,1,1,111,1215,1104
595,1,1,534,1217,683
596,1,0,121,0,-121
597,1,0,75,0,-75
598,1,1,1336,1743,407
599,1,0,44,0,-44
600,0,0,10,0,-10
601,1,0,11,0,-11
602,1,1,148,1946,1798
603,1,1,1616,1883,267
604,0,0,79,0,-79
605,0,0,74,0,-74
606,1,1,698,1705,1007
607,0,0,98,0,-98
608,0,0,33,0,-33
609,1,1,1384,1503,119
610,0,0,20,0,-20
611,1,1,309,1730,1421
612,1,1,104,2401,2297
613,0,0,222,0,-222
614,1,1,485,1212,727
615,0,0,147,0,-147
616,0,0,159,0,-159
617,1,1,909,2231,1322
618,0,0,40,0,-40
619,1,0,35,0,-35
620,0,0,101,0,-101
621,0,0,8,0,-8
622,1,0,43,0,-43
623,1,1,132,1592,1460
624,0,0,4,0,-4
625,0,0,15,0,-15
626,1,0,109,0,-109
627,1,0,57,0,-57
628,0,0,16,0,-16
629,1,1,329,1318,989
630,0,0,15,0,-15
631,1,0,64,0,-64
632,0,0,109,0,-109
633,0,0,4,0,-4
634,1,0,46,0,-46
635,1,0,51,0,-51
636,1,1,47,1221,1174
637,1,1,534,1239,705
638,1,0,7,0,-7
639,1,0,54,0,-54
640,0,0,248,0,-248
641,0,0,22,0,-22
642,1,0,60,0,-60
643,1,0,38,0,-38
644,0,0,3,0,-3
645,0,0,9,0,-9
646,1,1,181,1592,1411
647,1,1,323,1579,1256
648,0,0,27,0,-27
649,0,0,212,0,-212
650,1,0,35,0,-35
651,0,0,87,0,-87
652,0,0,60,0,-60
653,1,0,19,0,-19
654,1,0,4,0,-4
655,1,1,273,1964,1691
656,0,0,27,0,-27
657,1,1,289,1302,1013
658,0,0,0,0,0
659,0,0,33,0,-33
660,1,0,36,0,-36
661,1,1,1342,1538,196
662,1,1,429,2010,1581
663,0,0,27,0,-27
664,1,1,224,1392,1168
665,0,0,48,0,-48
666,1,1,521,1400,879
667,0,0,3,0,-3
668,0,0,45,0,-45
669,1,0,21,0,-21
670,0,0,55,0,-55
671,1,1,739,1408,669
672,1,1,934,1469,535
673,1,0,95,0,-95
674,1,1,354,1225,871
675,1,1,489,1259,770
676,1,1,2231,3623,1392
677,1,0,4,0,-4
678,0,0,32,0,-32
679,1,1,346,1434,1088
680,0,0,2,0,-2
681,1,0,58,0,-58
682,0,0,24,0,-24
683,0,0,54,0,-54
684,1,0,3,0,-3
685,1,1,239,1288,1049
686,0,0,103,0,-103
687,1,0,86,0,-86
688,1,0,44,0,-44
689,1,1,778,1333,555
690,1,1,629,1412,783
691,0,0,7,0,-7
692,1,1,1386,1725,339
693,1,1,150,2286,2136
694,1,0,73,0,-73
695,0,0,46,0,-46
696,0,0,17,0,-17
697,0,0,191,0,-191
698,1,1,127,1287,1160
699,1,0,24,0,-24
700,0,0,172,0,-172
701,1,1,263,1877,1614
702,1,1,836,1330,494
703,1,0,61,0,-61
704,1,0,5,0,-5
705,1,1,964,1288,324
706,1,0,24,0,-24
707,1,1,186,1419,1233
708,1,1,395,1728,1333
709,0,0,165,0,-165
710,1,0,38,0,-38
711,1,0,2,0,-2
712,1,0,15,0,-15
713,0,0,43,0,-43
714,0,0,12,0,-12
715,0,0,104,0,-104
716,0,0,10,0,-10
717,1,0,13,0,-13
718,1,0,90,0,-90
719,0,0,35,0,-35
720,1,1,62,1529,1467
721,0,0,63,0,-63
722,1,1,1225,2065,840
723,0,0,23,0,-23
724,1,0,48,0,-48
725,0,0,44,0,-44
726,0,0,13,0,-13
727,0,0,55,0,-55
728,0,0,31,0,-31
729,0,0,247,0,-247
730,1,1,995,1555,560
731,0,0,60,0,-60
732,0,0,87,0,-87
733,1,1,494,1598,1104
734,0,0,46,0,-46
735,1,1,291,2614,2323
736,0,0,8,0,-8
737,1,1,379,1747,1368
738,1,1,181,1238,1057
739,1,1,266,2137,1871
740,1,1,208,1430,1222
741,1,0,28,0,-28
742,1,1,329,2592,2263
743,0,0,46,0,-46
744,1,0,67,0,-67
745,1,1,128,1742,1614
746,1,1,256,1482,1226
747,1,1,405,1231,826
748,0,0,127,0,-127
749,0,0,70,0,-70
750,1,0,324,0,-324
751,1,0,23,0,-23
752,1,0,7,0,-7
753,1,0,43,0,-43
754,1,0,98,0,-98
755,1,1,881,1301,420
756,0,0,17,0,-17
757,0,0,10,0,-10
758,1,0,9,0,-9
759,1,0,11,0,-11
760,1,0,40,0,-40
761,0,0,56,0,-56
762,1,0,60,0,-60
763,1,0,0,0,0
764,0,0,35,0,-35
765,1,0,42,0,-42
766,0,0,26,0,-26
767,0,0,38,0,-38
768,1,0,136,0,-136
769,1,0,50,0,-50
770,1,0,53,0,-53
771,1,1,800,7113,6313
772,1,0,18,0,-18
773,0,0,26,0,-26
774,1,0,3,0,-3
775,0,0,82,0,-82
776,1,0,5,0,-5
777,1,0,74,0,-74
778,1,0,26,0,-26
779,1,0,31,0,-31
780,1,1,188,1299,1111
781,0,0,125,0,-125
782,0,0,69,0,-69
783,1,0,12,0,-12
784,0,0,152,0,-152
785,0,0,9,0,-9
786,0,0,96,0,-96
787,1,0,34,0,-34
788,0,0,1,0,-1
789,0,0,107,0,-107
790,1,0,27,0,-27
791,1,0,74,0,-74
792,1,0,45,0,-45
793,1,1,201,1260,1059
794,1,0,27,0,-27
795,1,1,358,1355,997
796,1,0,173,0,-173
797,0,0,64,0,-64
798,1,1,418,1365,947
799,1,1,1698,1299,-399
800,1,1,286,1232,946
801,0,0,24,0,-24
802,1,0,99,0,-99
803,1,1,371,1305,934
804,0,0,1,0,-1
805,0,0,3,0,-3
806,0,0,45,0,-45
807,1,0,22,0,-22
808,0,0,292,0,-292
809,0,0,13,0,-13
810,0,0,58,0,-58
811,1,1,654,1344,690
812,0,0,174,0,-174
813,1,1,1098,1215,117
814,1,1,187,2496,2309
815,1,0,59,0,-59
816,0,0,28,0,-28
817,0,0,56,0,-56
818,0,0,76,0,-76
819,1,1,400,1285,885
820,1,1,653,1261,608
821,1,0,137,0,-137
822,1,1,118,1332,1214
823,0,0,30,0,-30
824,0,0,5,0,-5
825,1,0,29,0,-29
826,1,0,121,0,-121
827,1,1,257,1702,1445
828,1,1,33,1248,1215
829,1,0,48,0,-48
830,1,0,0,0,0
831,1,0,21,0,-21
832,0,0,2,0,-2
833,1,0,22,0,-22
834,1,0,21,0,-21
835,1,1,1491,1207,-284
836,1,0,187,0,-187
837,1,0,77,0,-77
838,1,1,396,1369,973
839,1,0,51,0,-51
840,0,0,110,0,-110
841,1,0,24,0,-24
842,1,1,108,1455,1347
843,1,1,1332,1516,184
844,0,0,46,0,-46
845,0,0,26,0,-26
846,0,0,7,0,-7
847,1,1,621,1214,593
848,0,0,16,0,-16
849,1,1,252,1593,1341
850,1,1,1141,1208,67
851,1,1,447,1327,880
852,1,1,2260,1409,-851
853,1,1,542,1287,745
854,1,1,104,1557,1453
855,1,1,879,1762,883
856,0,0,74,0,-74
857,1,0,90,0,-90
858,1,1,119,1858,1739
859,1,0,5,0,-5
860,1,1,958,1660,702
861,1,0,99,0,-99
862,1,1,406,3166,2760
863,1,0,4,0,-4
864,1,0,66,0,-66
865,0,0,32,0,-32
866,0,0,20,0,-20
867,1,0,56,0,-56
868,1,1,1067,1325,258
869,1,1,229,1243,1014
870,1,0,23,0,-23
871,0,0,0,0,0
872,1,1,851,1295,444
873,1,1,884,1513,629
874,1,1,180,1839,1659
875,1,1,594,1826,1232
876,0,0,28,0,-28
877,0,0,15,0,-15
878,0,0,11,0,-11
879,0,0,48,0,-48
880,1,0,33,0,-33
881,0,0,45,0,-45
882,1,0,67,0,-67
883,0,0,218,0,-218
884,0,0,28,0,-28
885,0,0,94,0,-94
886,1,0,15,0,-15
887,1,0,25,0,-25
888,0,0,116,0,-116
889,0,0,40,0,-40
890,0,0,40,0,-40
891,0,0,202,0,-202
892,1,0,55,0,-55
893,1,0,40,0,-40
894,1,1,416,1389,973
895,0,0,29,0,-29
896,0,0,57,0,-57
897,1,1,498,1740,1242
898,1,1,534,1426,892
899,0,0,36,0,-36
900,0,0,106,0,-106
901,1,0,19,0,-19
902,1,1,759,1367,608
903,1,1,69,2326,2257
904,1,1,142,1490,1348
905,1,0,6,0,-6
906,0,0,34,0,-34
907,0,0,68,0,-68
908,0,0,2,0,-2
909,1,1,54,1646,1592
910,1,0,229,0,-229
911,1,1,244,2285,2041
912,0,0,7,0,-7
913,0,0,66,0,-66
914,1,0,145,0,-145
915,1,0,42,0,-42
916,1,0,6,0,-6
917,1,0,50,0,-50
918,1,0,79,0,-79
919,0,0,6,0,-6
920,1,0,26,0,-26
921,1,0,64,0,-64
922,1,0,2,0,-2
923,0,0,17,0,-17
924,1,0,9,0,-9
925,1,0,2,0,-2
926,1,1,499,1519,1020
927,0,0,41,0,-41
928,0,0,8,0,-8
929,0,0,13,0,-13
930,0,0,88,0,-88
931,1,1,1125,1379,254
932,0,0,0,0,0
933,1,0,90,0,-90
934,1,0,23,0,-23
935,1,0,0,0,0
936,1,0,35,0,-35
937,0,0,16,0,-16
938,1,1,501,1427,926
939,1,1,247,1258,1011
940,1,1,128,2603,2475
941,0,0,72,0,-72
942,1,1,60,1237,1177
943,1,1,1070,1207,137
944,0,0,9,0,-9
945,1,1,3384,1342,-2042
946,0,0,8,0,-8
947,1,0,58,0,-58
948,1,0,38,0,-38
949,0,0,130,0,-130
950,1,0,16,0,-16
951,0,0,3,0,-3
952,1,0,224,0,-224
953,0,0,59,0,-59
954,0,0,88,0,-88
955,0,0,14,0,-14
956,0,0,81,0,-81
957,1,0,29,0,-29
958,1,0,80,0,-80
959,1,0,15,0,-15
960,0,0,26,0,-26
961,1,0,3,0,-3
962,1,0,43,0,-43
963,0,0,26,0,-26
964,1,0,106,0,-106
965,1,0,45,0,-45
966,1,1,88,1386,1298
967,0,0,9,0,-9
968,1,1,733,1605,872
969,1,0,22,0,-22
970,0,0,84,0,-84
971,1,0,24,0,-24
972,1,1,478,2130,1652
973,1,1,101,1934,1833
974,1,0,3,0,-3
975,1,1,238,2282,2044
976,1,0,11,0,-11
977,0,0,0,0,0
978,1,1,1549,1487,-62
979,1,0,16,0,-16
980,0,0,116,0,-116
981,0,0,57,0,-57
982,1,0,5,0,-5
983,1,0,127,0,-127
984,0,0,174,0,-174
985,0,0,27,0,-27
986,0,0,38,0,-38
987,0,0,1,0,-1
988,0,0,63,0,-63
989,1,0,67,0,-67
990,1,1,114,1225,1111
991,1,1,1386,1916,530
992,1,1,1140,1391,251
993,0,0,128,0,-128
994,0,0,77,0,-77
995,0,0,80,0,-80
996,1,0,60,0,-60
997,0,0,15,0,-15
998,1,1,477,2194,1717
999,0,0,74,0,-74
1000,0,0,94,0,-94
1001,1,0,27,0,-27
1002,0,0,18,0,-18
1003,0,0,102,0,-102
1004,0,0,42,0,-42
1005,0,0,10,0,-10
1006,0,0,28,0,-28
1007,0,0,35,0,-35
1008,1,1,271,1202,931
1009,1,1,196,1240,1044
1010,1,1,666,1288,622
1011,1,1,849,1249,400
1012,1,0,86,0,-86
1013,0,0,55,0,-55
1014,1,0,12,0,-12
1015,1,0,70,0,-70
1016,1,0,154,0,-154
1017,1,1,783,1460,677
1018,1,1,694,5359,4665
1019,0,0,77,0,-77
1020,0,0,13,0,-13
1021,0,0,69,0,-69
1022,1,0,217,0,-217
1023,1,0,39,0,-39
1024,0,0,11,0,-11
1025,1,1,971,1659,688
1026,0,0,29,0,-29
1027,0,0,114,0,-114
1028,1,1,738,1398,660
1029,1,0,5,0,-5
1030,0,0,30,0,-30
1031,0,0,30,0,-30
1032,1,1,234,1249,1015
1033,1,1,1129,1459,330
1034,1,1,168,1479,1311
1035,1,0,46,0,-46
1036,1,0,6,0,-6
1037,1,1,112,1598,1486
1038,0,0,50,0,-50
1039,1,1,260,1499,1239
1040,1,0,54,0,-54
1041,0,0,9,0,-9
1042,0,0,143,0,-143
1043,1,0,42,0,-42
1044,1,0,96,0,-96
1045,1,1,269,1208,939
1046,1,0,95,0,-95
1047,0,0,35,0,-35
1048,1,1,302,1206,904
1049,1,1,517,1542,1025
1050,0,0,73,0,-73
1051,0,0,5,0,-5
1052,1,1,252,1520,1268
1053,0,0,9,0,-9
1054,0,0,1,0,-1
1055,1,1,400,1242,842
1056,1,1,374,2428,2054
1057,1,0,158,0,-158
1058,1,0,0,0,0
1059,1,0,19,0,-19
1060,0,0,43,0,-43
1061,0,0,19,0,-19
1062,0,0,79,0,-79
1063,0,0,0,0,0
1064,1,1,574,1266,692
1065,1,0,6,0,-6
1066,1,0,13,0,-13
1067,0,0,14,0,-14
1068,1,0,3,0,-3
1069,1,1,145,1348,1203
1070,0,0,38,0,-38
1071,1,1,64,1478,1414
1072,1,1,339,1217,878
1073,0,0,65,0,-65
1074,1,1,332,1444,1112
1075,0,0,8,0,-8
1076,1,1,283,1822,1539
1077,0,0,3,0,-3
1078,0,0,43,0,-43
1079,1,0,1,0,-1
1080,1,1,707,1303,596
1081,1,1,241,1433,1192
1082,1,0,64,0,-64
1083,0,0,150,0,-150
1084,1,0,14,0,-14
1085,1,1,738,2288,1550
1086,0,0,160,0,-160
1087,1,1,1732,1225,-507
1088,1,0,54,0,-54
1089,1,1,429,1292,863
1090,1,0,0,0,0
1091,1,1,368,1944,1576
1092,0,0,72,0,-72
1093,1,0,14,0,-14
1094,0,0,64,0,-64
1095,0,0,129,0,-129
1096,0,0,68,0,-68
1097,0,0,124,0,-124
1098,1,0,10,0,-10
1099,0,0,113,0,-113
1100,0,0,111,0,-111
1101,1,0,53,0,-53
1102,1,1,772,1234,462
1103,1,1,968,1565,597
1104,1,1,182,1247,1065
1105,1,1,71,1717,1646
1106,1,0,65,0,-65
1107,1,0,2,0,-2
1108,1,0,18,0,-18
1109,0,0,31,0,-31
1110,0,0,111,0,-111
1111,1,0,93,0,-93
1112,1,0,51,0,-51
1113,1,0,5,0,-5
1114,0,0,94,0,-94
1115,1,0,87,0,-87
1116,1,0,0,0,0
1117,1,0,27,0,-27
1118,1,1,620,1419,799
1119,1,1,821,1397,576
1120,0,0,61,0,-61
1121,0,0,96,0,-96
1122,1,1,123,1244,1121
1123,1,0,37,0,-37
1124,1,1,101,1276,1175
1125,0,0,19,0,-19
1126,0,0,25,0,-25
1127,0,0,47,0,-47
1128,1,0,15,0,-15
1129,0,0,19,0,-19
1130,1,0,11,0,-11
1131,0,0,24,0,-24
1132,1,1,78,2837,2759
1133,0,0,35,0,-35
1134,0,0,15,0,-15
1135,1,0,56,0,-56
1136,1,0,65,0,-65
1137,0,0,120,0,-120
1138,1,0,12,0,-12
1139,1,1,304,1501,1197
1140,0,0,23,0,-23
1141,1,0,53,0,-53
1142,0,0,24,0,-24
1143,0,0,154,0,-154
1144,1,1,426,1905,1479
1145,1,1,164,1766,1602
1146,1,1,61,1447,1386
1147,1,1,365,1334,969
1148,0,0,93,0,-93
1149,1,1,51,2597,2546
1150,1,0,54,0,-54
1151,1,0,106,0,-106
1152,1,1,161,1485,1324
1153,0,0,18,0,-18
1154,1,1,125,1286,1161
1155,0,0,29,0,-29
1156,0,0,23,0,-23
1157,1,0,47,0,-47
1158,0,0,42,0,-42
1159,1,1,281,2717,2436
1160,1,0,128,0,-128
1161,0,0,91,0,-91
1162,0,0,50,0,-50
1163,1,1,704,1461,757
1164,0,0,10,0,-10
1165,0,0,26,0,-26
1166,1,1,281,1576,1295
1167,1,1,1801,1326,-475
1168,0,0,20,0,-20
1169,1,1,846,1614,768
1170,0,0,48,0,-48
1171,0,0,9,0,-9
1172,1,0,1,0,-1
1173,1,0,40,0,-40
1174,0,0,34,0,-34
1175,1,0,31,0,-31
1176,1,1,415,1231,816
1177,0,0,74,0,-74
1178,0,0,4,0,-4
1179,1,1,264,1562,1298
1180,0,0,26,0,-26
1181,0,0,117,0,-117
1182,1,1,299,1404,1105
1183,0,0,223,0,-223
1184,1,1,283,1353,1070
1185,1,1,600,1243,643
1186,1,1,719,1360,641
1187,1,0,78,0,-78
1188,1,0,16,0,-16
1189,1,0,167,0,-167
1190,1,1,777,1881,1104
1191,1,1,326,2889,2563
1192,0,0,256,0,-256
1193,1,0,0,0,0
1194,1,0,15,0,-15
1195,1,0,4,0,-4
1196,1,0,184,0,-184
1197,1,0,19,0,-19
1198,1,0,30,0,-30
1199,0,0,38,0,-38
1200,0,0,16,0,-16
1201,1,0,86,0,-86
1202,0,0,13,0,-13
1203,1,1,534,1884,1350
1204,1,1,86,1837,1751
1205,1,0,1,0,-1
1206,0,0,77,0,-77
1207,1,0,64,0,-64
1208,1,0,154,0,-154
1209,0,0,12,0,-12
1210,1,1,228,1353,1125
1211,1,1,751,1257,506
1212,1,1,660,1570,910
1213,1,1,1012,1576,564
1214,1,1,1166,1493,327
1215,1,1,506,1254,748
1216,0,0,1,0,-1
1217,1,1,195,1330,1135
1218,0,0,58,0,-58
1219,1,0,2,0,-2
1220,0,0,90,0,-90
1221,1,1,413,1922,1509
1222,0,0,117,0,-117
1223,1,1,438,1249,811
1224,1,0,15,0,-15
1225,1,1,2359,1351,-1008
1226,1,0,73,0,-73
1227,1,0,60,0,-60
1228,0,0,9,0,-9
1229,1,1,511,1250,739
1230,1,1,287,1852,1565
1231,1,1,112,1631,1519
1232,1,1,177,1834,1657
1233,1,0,48,0,-48
1234,0,0,25,0,-25
1235,1,1,688,1240,552
1236,0,0,155,0,-155
1237,0,0,7,0,-7
1238,1,1,314,1224,910
1239,0,0,20,0,-20
1240,1,1,1411,2457,1046
1241,1,1,397,1687,1290
1242,1,1,331,2640,2309
1243,1,0,12,0,-12
1244,1,0,4,0,-4
1245,1,0,12,0,-12
1246,0,0,31,0,-31
1247,1,0,43,0,-43
1248,0,0,4,0,-4
1249,1,0,60,0,-60
1250,1,1,354,1613,1259
1251,0,0,64,0,-64
1252,1,1,215,1763,1548
1253,1,1,169,1284,1115
1254,1,0,13,0,-13
1255,0,0,73,0,-73
1256,0,0,6,0,-6
1257,0,0,9,0,-9
1258,1,1,178,1223,1045
1259,1,0,78,0,-78
1260,0,0,23,0,-23
1261,1,0,0,0,0
1262,0,0,44,0,-44
1263,1,1,195,1214,1019
1264,1,0,10,0,-10
1265,1,1,530,2054,1524
1266,1,1,518,1415,897
1267,1,1,675,1794,1119
1268,0,0,38,0,-38
1269,0,0,75,0,-75
1270,0,0,51,0,-51
1271,0,0,118,0,-118
1272,1,0,47,0,-47
1273,0,0,17,0,-17
1274,0,0,132,0,-132
1275,1,0,116,0,-116
1276,1,1,191,2015,1824
1277,1,0,8,0,-8
1278,0,0,20,0,-20
1279,1,0,107,0,-107
1280,0,0,27,0,-27
1281,1,1,1898,2113,215
1282,0,0,8,0,-8
1283,0,0,89,0,-89
1284,0,0,191,0,-191
1285,1,1,53,1841,1788
1286,0,0,12,0,-12
1287,1,1,328,1891,1563
1288,0,0,42,0,-42
1289,1,0,3,0,-3
1290,1,0,3,0,-3
1291,0,0,7,0,-7
1292,1,1,551,1578,1027
1293,1,0,38,0,-38
1294,1,0,20,0,-20
1295,1,0,0,0,0
1296,1,0,83,0,-83
1297,1,0,8,0,-8
1298,0,0,11,0,-11
1299,0,0,15,0,-15
1300,0,0,17,0,-17
1301,0,0,25,0,-25
1302,0,0,159,0,-159
1303,0,0,5,0,-5
1304,1,0,126,0,-126
1305,1,1,294,1228,934
1306,0,0,42,0,-42
1307,1,0,27,0,-27
1308,1,1,566,1261,695
1309,1,1,787,1220,433
1310,1,0,39,0,-39
1311,0,0,28,0,-28
1312,0,0,10,0,-10
1313,1,0,26,0,-26
1314,1,1,179,1374,1195
1315,1,0,64,0,-64
1316,0,0,27,0,-27
1317,1,1,227,1367,1140
1318,0,0,16,0,-16
1319,1,0,40,0,-40
1320,0,0,69,0,-69
1321,0,0,1,0,-1
1322,1,0,128,0,-128
1323,0,0,105,0,-105
1324,1,1,659,1814,1155
1325,0,0,12,0,-12
1326,1,0,53,0,-53
1327,1,0,3,0,-3
1328,1,1,150,1272,1122
1329,1,0,27,0,-27
1330,1,1,105,1416,1311
1331,0,0,74,0,-74
1332,1,1,499,1222,723
1333,0,0,94,0,-94
1334,1,0,13,0,-13
1335,1,0,49,0,-49
1336,1,1,57,1305,1248
1337,1,0,86,0,-86
1338,0,0,25,0,-25
1339,1,0,82,0,-82
1340,1,1,598,2134,1536
1341,0,0,52,0,-52
1342,1,1,427,1347,920
1343,0,0,59,0,-59
1344,0,0,40,0,-40
1345,1,0,40,0,-40
1346,1,1,1089,1958,869
1347,1,1,514,1400,886
1348,1,1,576,1446,870
1349,1,0,4,0,-4
1350,0,0,48,0,-48
1351,0,0,28,0,-28
1352,0,0,22,0,-22
1353,0,0,10,0,-10
1354,0,0,108,0,-108
1355,1,1,132,1269,1137
1356,1,0,114,0,-114
1357,0,0,7,0,-7
1358,1,1,456,1441,985
1359,1,0,6,0,-6
1360,0,0,37,0,-37
1361,0,0,146,0,-146
1362,1,0,42,0,-42
1363,1,0,0,0,0
1364,1,1,247,1512,1265
1365,0,0,45,0,-45
1366,0,0,1,0,-1
1367,1,0,5,0,-5
1368,1,1,1298,1266,-32
1369,1,0,29,0,-29
1370,0,0,45,0,-45
1371,1,1,381,1614,1233
1372,0,0,102,0,-102
1373,1,1,1880,1621,-259
1374,0,0,12,0,-12
1375,1,1,609,1222,613
1376,1,1,37,1663,1626
1377,1,1,122,1281,1159
1378,0,0,32,0,-32
1379,1,0,82,0,-82
1380,1,1,1194,2477,1283
1381,0,0,3,0,-3
1382,0,0,72,0,-72
1383,1,1,661,1346,685
1384,1,0,9,0,-9
1385,0,0,76,0,-76
1386,1,1,1739,1257,-482
1387,1,0,6,0,-6
1388,1,0,71,0,-71
1389,1,0,146,0,-146
1390,0,0,39,0,-39
1391,1,0,35,0,-35
1392,0,0,59,0,-59
1393,0,0,1,0,-1
1394,0,0,17,0,-17
1395,1,0,9,0,-9
1396,1,1,2037,2839,802
1397,1,0,122,0,-122
1398,1,0,41,0,-41
1399,0,0,83,0,-83
1400,1,1,218,1315,1097
1401,1,0,10,0,-10
1402,1,1,1582,1410,-172
1403,0,0,29,0,-29
1404,0,0,56,0,-56
1405,0,0,54,0,-54
1406,0,0,85,0,-85
1407,1,0,112,0,-112
1408,0,0,112,0,-112
1409,1,1,1259,1214,-45
1410,1,0,13,0,-13
1411,0,0,39,0,-39
1412,0,0,77,0,-77
1413,1,0,214,0,-214
1414,0,0,6,0,-6
1415,1,0,18,0,-18
1416,1,1,556,1298,742
1417,1,0,28,0,-28
1418,0,0,18,0,-18
1419,1,1,976,1428,452
1420,1,0,138,0,-138
1421,0,0,75,0,-75
1422,0,0,14,0,-14
1423,0,0,48,0,-48
1424,1,1,2236,1420,-816
1425,1,1,37,2626,2589
1426,0,0,5,0,-5
1427,1,0,67,0,-67
1428,1,0,24,0,-24
1429,0,0,0,0,0
1430,1,0,34,0,-34
1431,1,0,49,0,-49
1432,1,1,835,1629,794
1433,1,1,405,2132,1727
1434,1,0,21,0,-21
1435,0,0,100,0,-100
1436,0,0,128,0,-128
1437,0,0,23,0,-23
1438,0,0,33,0,-33
1439,1,0,6,0,-6
1440,1,1,89,1298,1209
1441,1,1,395,1319,924
1442,1,1,1568,1475,-93
1443,1,1,170,1301,1131
1444,1,0,212,0,-212
1445,1,0,38,0,-38
1446,1,0,14,0,-14
1447,1,1,1779,1413,-366
1448,1,0,6,0,-6
1449,0,0,8,0,-8
1450,1,1,352,1492,1140
1451,0,0,20,0,-20
1452,0,0,0,0,0
1453,1,1,85,1264,1179
1454,1,0,161,0,-161
1455,1,0,18,0,-18
1456,0,0,46,0,-46
1457,1,1,603,2274,1671
1458,0,0,45,0,-45
1459,1,1,1246,1296,50
1460,1,1,263,2270,2007
1461,1,0,4,0,-4
1462,0,0,178,0,-178
1463,1,1,1114,1335,221
1464,1,0,83,0,-83
1465,1,0,67,0,-67
1466,1,0,26,0,-26
1467,1,0,16,0,-16
1468,0,0,124,0,-124
1469,0,0,0,0,0
1470,1,1,137,1221,1084
1471,1,1,397,1451,1054
1472,0,0,72,0,-72
1473,0,0,22,0,-22
1474,0,0,7,0,-7
1475,0,0,10,0,-10
1476,1,1,968,1683,715
1477,0,0,109,0,-109
1478,1,0,39,0,-39
1479,1,0,7,0,-7
1480,0,0,50,0,-50
1481,1,1,705,1261,556
1482,0,0,15,0,-15
1483,0,0,31,0,-31
1484,1,1,659,1239,580
1485,1,0,0,0,0
1486,1,0,29,0,-29
1487,1,0,142,0,-142
1488,0,0,6,0,-6
1489,1,0,34,0,-34
1490,0,0,111,0,-111
1491,1,0,69,0,-69
1492,1,1,368,1305,937
1493,0,0,99,0,-99
1494,1,1,249,1418,1169
1495,1,1,665,1355,690
1496,1,0,128,0,-128
1497,0,0,1,0,-1
1498,0,0,74,0,-74
1499,0,0,63,0,-63
1500,0,0,0,0,0
1501,1,1,1015,1299,284
1502,1,0,36,0,-36
1503,0,0,9,0,-9
1504,1,0,1,0,-1
1505,1,0,44,0,-44
1506,1,0,3,0,-3
1507,0,0,26,0,-26
1508,1,1,1438,1888,450
1509,1,1,357,1748,1391
1510,1,0,6,0,-6
1511,0,0,59,0,-59
1512,0,0,41,0,-41
1513,1,0,245,0,-245
1514,0,0,14,0,-14
1515,0,0,100,0,-100
1516,0,0,9,0,-9
1517,0,0,6,0,-6
1518,0,0,74,0,-74
1519,1,0,5,0,-5
1520,1,0,72,0,-72
1521,0,0,1,0,-1
1522,0,0,45,0,-45
1523,1,0,77,0,-77
1524,1,0,32,0,-32
1525,1,1,856,1256,400
1526,1,0,64,0,-64
1527,0,0,133,0,-133
1528,1,0,39,0,-39
1529,1,0,59,0,-59
1530,1,0,18,0,-18
1531,1,0,16,0,-16
1532,1,1,134,1211,1077
1533,1,0,19,0,-19
1534,0,0,38,0,-38
1535,0,0,12,0,-12
1536,1,0,60,0,-60
1537,1,0,121,0,-121
1538,1,0,112,0,-112
1539,1,1,1561,2031,470
1540,1,0,31,0,-31
1541,0,0,56,0,-56
1542,0,0,65,0,-65
1543,0,0,5,0,-5
1544,1,0,65,0,-65
1545,0,0,1,0,-1
1546,0,0,8,0,-8
1547,1,1,1690,2291,601
1548,1,1,1138,1665,527
1549,1,1,662,1383,721
1550,1,0,19,0,-19
1551,1,0,55,0,-55
1552,0,0,87,0,-87
1553,1,0,89,0,-89
1554,1,0,77,0,-77
1555,1,1,335,1520,1185
1556,1,0,1,0,-1
1557,0,0,143,0,-143
1558,0,0,40,0,-40
1559,0,0,26,0,-26
1560,1,1,268,1227,959
1561,1,0,35,0,-35
1562,1,0,27,0,-27
1563,0,0,25,0,-25
1564,0,0,70,0,-70
1565,0,0,45,0,-45
1566,0,0,15,0,-15
1567,0,0,73,0,-73
1568,0,0,17,0,-17
1569,0,0,42,0,-42
1570,0,0,62,0,-62
1571,0,0,18,0,-18
1572,1,1,757,1354,597
1573,0,0,18,0,-18
1574,0,0,16,0,-16
1575,0,0,117,0,-117
1576,1,1,307,2156,1849
1577,1,0,219,0,-219
1578,1,1,106,1363,1257
1579,0,0,102,0,-102
1580,1,1,358,1706,1348
1581,1,0,21,0,-21
1582,1,0,13,0,-13
1583,0,0,14,0,-14
1584,1,0,40,0,-40
1585,0,0,11,0,-11
1586,0,0,21,0,-21
1587,0,0,55,0,-55
1588,1,0,14,0,-14
1589,1,0,6,0,-6
1590,0,0,24,0,-24
1591,1,1,51,1349,1298
1592,0,0,37,0,-37
1593,0,0,22,0,-22
1594,0,0,50,0,-50
1595,1,0,17,0,-17
1596,0,0,14,0,-14
1597,1,0,33,0,-33
1598,0,0,39,0,-39
1599,1,1,2179,1283,-896
1600,1,0,30,0,-30
1601,1,0,0,0,0
1602,1,1,353,1418,1065
1603,0,0,18,0,-18
1604,1,0,4,0,-4
1605,1,0,49,0,-49
1606,0,0,10,0,-10
1607,1,1,29,1337,1308
1608,0,0,1,0,-1
1609,1,0,48,0,-48
1610,1,0,1,0,-1
1611,0,0,20,0,-20
1612,1,1,135,1213,1078
1613,0,0,147,0,-147
1614,0,0,55,0,-55
1615,0,0,53,0,-53
1616,1,1,1512,2178,666
1617,1,1,2050,2704,654
1618,1,1,392,1301,909
1619,1,1,296,1452,1156
1620,0,0,33,0,-33
1621,0,0,9,0,-9
1622,1,1,333,1270,937
1623,1,0,83,0,-83
1624,1,0,91,0,-91
1625,0,0,227,0,-227
1626,0,0,140,0,-140
1627,1,1,418,1288,870
1628,0,0,9,0,-9
1629,1,0,20,0,-20
1630,1,1,786,1356,570
1631,1,1,369,1722,1353
1632,1,1,620,1252,632
1633,1,1,606,1556,950
1634,1,1,294,1399,1105
1635,0,0,9,0,-9
1636,1,1,798,1433,635
1637,0,0,34,0,-34
1638,1,1,456,1363,907
1639,0,0,74,0,-74
1640,1,0,48,0,-48
1641,0,0,11,0,-11
1642,1,1,327,1327,1000
1643,0,0,19,0,-19
1644,0,0,62,0,-62
1645,0,0,27,0,-27
1646,1,0,30,0,-30
1647,0,0,308,0,-308
1648,1,0,46,0,-46
1649,1,0,53,0,-53
1650,1,0,51,0,-51
1651,1,0,52,0,-52
1652,0,0,13,0,-13
1653,1,1,57,1228,1171
1654,1,0,17,0,-17
1655,0,0,48,0,-48
1656,0,0,57,0,-57
1657,0,0,38,0,-38
1658,1,0,25,0,-25
1659,1,0,46,0,-46
1660,0,0,19,0,-19
1661,0,0,91,0,-91
1662,0,0,1,0,-1
1663,1,1,101,1661,1560
1664,1,1,253,1296,1043
1665,0,0,80,0,-80
1666,1,1,446,1389,943
1667,0,0,0,0,0
1668,1,0,2,0,-2
1669,0,0,59,0,-59
1670,1,1,386,1394,1008
1671,1,0,156,0,-156
1672,1,0,62,0,-62
1673,1,1,12,1246,1234
1674,0,0,6,0,-6
1675,0,0,48,0,-48
1676,1,0,86,0,-86
1677,0,0,38,0,-38
1678,0,0,32,0,-32
1679,1,0,0,0,0
1680,0,0,12,0,-12
1681,1,0,25,0,-25
1682,0,0,1,0,-1
1683,1,0,36,0,-36
1684,0,0,45,0,-45
1685,1,1,1608,1781,173
1686,1,0,83,0,-83
1687,1,0,75,0,-75
1688,0,0,11,0,-11
1689,0,0,129,0,-129
1690,0,0,73,0,-73
1691,0,0,15,0,-15
1692,0,0,9,0,-9
1693,0,0,31,0,-31
1694,0,0,145,0,-145
1695,0,0,1,0,-1
1696,1,1,471,1402,931
1697,0,0,204,0,-204
1698,1,0,0,0,0
1699,0,0,75,0,-75
1700,1,1,597,1342,745
1701,0,0,60,0,-60
1702,1,0,77,0,-77
1703,0,0,16,0,-16
1704,1,1,52,1665,1613
1705,0,0,143,0,-143
1706,1,0,18,0,-18
1707,1,0,32,0,-32
1708,1,1,614,1491,877
1709,0,0,59,0,-59
1710,1,0,148,0,-148
1711,0,0,53,0,-53
1712,0,0,16,0,-16
1713,1,0,42,0,-42
1714,0,0,38,0,-38
1715,1,1,340,1651,1311
1716,1,0,2,0,-2
1717,0,0,9,0,-9
1718,1,1,441,1374,933
1719,0,0,12,0,-12
1720,0,0,25,0,-25
1721,1,1,770,1812,1042
1722,1,1,60,2071,2011
1723,0,0,51,0,-51
1724,0,0,11,0,-11
1725,0,0,5,0,-5
1726,1,1,333,1247,914
1727,1,1,1092,1305,213
1728,0,0,33,0,-33
1729,1,0,154,0,-154
1730,1,1,523,1243,720
1731,1,0,112,0,-112
1732,1,1,74,1251,1177
1733,1,1,1063,1204,141
1734,1,0,16,0,-16
1735,1,1,167,1389,1222
1736,0,0,12,0,-12
1737,0,0,27,0,-27
1738,1,0,45,0,-45
1739,0,0,63,0,-63
1740,0,0,26,0,-26
1741,1,0,46,0,-46
1742,1,1,106,1625,1519
1743,0,0,2,0,-2
1744,1,1,136,1554,1418
1745,0,0,9,0,-9
1746,1,1,416,1278,862
1747,0,0,27,0,-27
1748,1,0,2,0,-2
1749,0,0,40,0,-40
1750,1,1,596,1211,615
1751,1,1,573,1873,1300
1752,1,1,922,1891,969
1753,0,0,30,0,-30
1754,0,0,21,0,-21
1755,1,1,168,1292,1124
1756,0,0,61,0,-61
1757,0,0,79,0,-79
1758,1,0,24,0,-24
1759,1,0,70,0,-70
1760,0,0,3,0,-3
1761,1,1,133,1318,1185
1762,1,0,70,0,-70
1763,0,0,16,0,-16
1764,1,1,949,1424,475
1765,0,0,19,0,-19
1766,1,1,843,1361,518
1767,1,1,126,1855,1729
1768,1,0,60,0,-60
1769,1,1,453,1277,824
1770,1,0,0,0,0
1771,1,0,79,0,-79
1772,1,1,184,2647,2463
1773,0,0,57,0,-57
1774,1,0,36,0,-36
1775,0,0,44,0,-44
1776,1,1,410,1214,804
1777,1,0,2,0,-2
1778,1,0,0,0,0
1779,0,0,26,0,-26
1780,0,0,13,0,-13
1781,0,0,14,0,-14
1782,0,0,39,0,-39
1783,0,0,44,0,-44
1784,1,1,345,1596,1251
1785,1,1,486,1440,954
1786,0,0,37,0,-37
1787,0,0,2,0,-2
1788,1,0,16,0,-16
1789,1,0,54,0,-54
1790,0,0,41,0,-41
1791,1,0,3,0,-3
1792,0,0,8,0,-8
1793,1,0,47,0,-47
1794,0,0,15,0,-15
1795,0,0,138,0,-138
1796,0,0,46,0,-46
1797,0,0,52,0,-52
1798,1,0,5,0,-5
1799,1,1,601,2573,1972
1800,1,1,124,2724,2600
1801,1,0,58,0,-58
1802,1,0,8,0,-8
1803,1,1,103,1312,1209
1804,1,0,3,0,-3
1805,0,0,78,0,-78
1806,0,0,24,0,-24
1807,1,1,456,1442,986
1808,1,0,31,0,-31
1809,1,0,17,0,-17
1810,1,0,34,0,-34
1811,0,0,17,0,-17
1812,1,0,99,0,-99
1813,1,0,66,0,-66
1814,1,0,2,0,-2
1815,1,0,21,0,-21
1816,0,0,89,0,-89
1817,0,0,11,0,-11
1818,0,0,182,0,-182
1819,1,0,40,0,-40
1820,1,0,20,0,-20
1821,0,0,13,0,-13
1822,1,1,872,1419,547
1823,1,1,959,1580,621
1824,1,0,29,0,-29
1825,0,0,75,0,-75
1826,0,0,1,0,-1
1827,1,1,516,1345,829
1828,1,1,1630,1406,-224
1829,1,1,2745,1211,-1534
1830,0,0,34,0,-34
1831,1,1,158,1306,1148
1832,1,1,221,2861,2640
1833,1,0,29,0,-29
1834,0,0,319,0,-319
1835,1,1,60,1217,1157
1836,1,0,115,0,-115
1837,0,0,20,0,-20
1838,1,1,483,1652,1169
1839,0,0,23,0,-23
1840,0,0,75,0,-75
1841,1,0,19,0,-19
1842,1,0,62,0,-62
1843,1,0,99,0,-99
1844,0,0,30,0,-30
1845,0,0,1,0,-1
1846,0,0,12,0,-12
1847,1,1,42,1216,1174
1848,1,0,108,0,-108
1849,0,0,102,0,-102
1850,0,0,111,0,-111
1851,1,1,413,1406,993
1852,1,0,139,0,-139
1853,1,1,2022,3852,1830
1854,1,0,13,0,-13
1855,0,0,25,0,-25
1856,1,0,85,0,-85
1857,0,0,53,0,-53
1858,1,0,19,0,-19
1859,1,0,35,0,-35
1860,0,0,1,0,-1
1861,0,0,83,0,-83
1862,1,1,1032,1241,209
1863,1,1,584,1278,694
1864,0,0,1,0,-1
1865,1,1,322,1270,948
1866,1,1,1180,1410,230
1867,0,0,0,0,0
1868,1,1,518,1516,998
1869,0,0,24,0,-24
1870,1,0,6,0,-6
1871,1,1,9,1224,1215
1872,1,0,61,0,-61
1873,0,0,10,0,-10
1874,1,0,56,0,-56
1875,1,1,389,2075,1686
1876,1,0,71,0,-71
1877,0,0,14,0,-14
1878,0,0,9,0,-9
1879,0,0,49,0,-49
1880,1,0,189,0,-189
1881,0,0,123,0,-123
1882,0,0,38,0,-38
1883,1,1,151,1264,1113
1884,1,0,12,0,-12
1885,1,1,90,2556,2466
1886,1,1,237,3610,3373
1887,0,0,21,0,-21
1888,0,0,68,0,-68
1889,0,0,84,0,-84
1890,1,1,804,2005,1201
1891,0,0,24,0,-24
1892,0,0,9,0,-9
1893,0,0,56,0,-56
1894,0,0,29,0,-29
1895,1,1,102,1617,1515
1896,1,1,1085,1439,354
1897,0,0,44,0,-44
1898,0,0,70,0,-70
1899,1,0,14,0,-14
1900,1,1,1136,2372,1236
1901,0,0,33,0,-33
1902,0,0,52,0,-52
1903,0,0,17,0,-17
1904,0,0,12,0,-12
1905,0,0,20,0,-20
1906,1,1,219,1726,1507
1907,1,0,28,0,-28
1908,0,0,33,0,-33
1909,1,0,129,0,-129
1910,0,0,26,0,-26
1911,1,1,476,1867,1391
1912,0,0,0,0,0
1913,0,0,116,0,-116
1914,1,0,31,0,-31
1915,0,0,54,0,-54
1916,1,0,3,0,-3
1917,1,1,269,1660,1391
1918,1,1,520,1482,962
1919,0,0,39,0,-39
1920,1,1,125,1584,1459
1921,0,0,19,0,-19
1922,1,1,78,2010,1932
1923,1,1,344,1651,1307
1924,1,0,15,0,-15
1925,1,1,84,1385,1301
1926,0,0,20,0,-20
1927,1,1,253,1202,949
1928,1,0,24,0,-24
1929,1,0,84,0,-84
1930,1,0,49,0,-49
1931,1,0,234,0,-234
1932,1,0,49,0,-49
1933,1,0,19,0,-19
1934,1,0,11,0,-11
1935,0,0,32,0,-32
1936,0,0,2,0,-2
1937,1,1,1823,1355,-468
1938,1,0,17,0,-17
1939,1,1,591,1480,889
1940,0,0,0,0,0
1941,1,0,140,0,-140
1942,1,1,1754,1235,-519
1943,1,1,225,1832,1607
1944,0,0,30,0,-30
1945,1,0,6,0,-6
1946,0,0,50,0,-50
1947,1,0,114,0,-114
1948,1,0,70,0,-70
1949,1,1,579,1274,695
1950,0,0,48,0,-48
1951,1,1,712,1556,844
1952,0,0,78,0,-78
1953,0,0,25,0,-25
1954,1,0,16,0,-16
1955,1,0,12,0,-12
1956,1,1,620,2671,2051
1957,0,0,20,0,-20
1958,0,0,23,0,-23
1959,1,1,587,1685,1098
1960,0,0,68,0,-68
1961,1,1,1059,1245,186
1962,0,0,29,0,-29
1963,0,0,33,0,-33
1964,1,1,836,1289,453
1965,0,0,6,0,-6
1966,0,0,115,0,-115
1967,1,1,949,1426,477
1968,0,0,99,0,-99
1969,1,1,223,2430,2207
1970,0,0,162,0,-162
1971,1,1,201,1781,1580
1972,1,1,127,1722,1595
1973,1,0,81,0,-81
1974,1,0,58,0,-58
1975,1,1,989,2189,1200
1976,1,1,612,1244,632
1977,0,0,34,0,-34
1978,1,0,12,0,-12
1979,1,0,19,0,-19
1980,0,0,43,0,-43
1981,1,1,597,1255,658
1982,1,1,699,2667,1968
1983,1,1,387,1564,1177
1984,1,1,412,1271,859
1985,1,0,71,0,-71
1986,0,0,13,0,-13
1987,0,0,60,0,-60
1988,1,0,3,0,-3
1989,1,0,41,0,-41
1990,1,0,7,0,-7
1991,1,0,76,0,-76
1992,1,1,902,1205,303
1993,0,0,83,0,-83
1994,1,0,32,0,-32
1995,1,0,31,0,-31
1996,1,1,274,1667,1393
1997,0,0,40,0,-40
1998,1,1,332,1415,1083
1999,1,1,205,1238,1033
2000,0,0,92,0,-92
2001,0,0,137,0,-137
2002,1,0,18,0,-18
2003,1,1,104,1332,1228
2004,0,0,36,0,-36
2005,1,0,149,0,-149
2006,1,0,46,0,-46
2007,0,0,101,0,-101
2008,1,0,34,0,-34
2009,0,0,10,0,-10
2010,0,0,5,0,-5
2011,0,0,53,0,-53
2012,1,0,14,0,-14
2013,1,1,972,1357,385
2014,1,0,96,0,-96
2015,0,0,50,0,-50
2016,1,1,2132,1295,-837
2017,1,1,326,1209,883
2018,1,1,777,1488,711
2019,0,0,17,0,-17
2020,0,0,10,0,-10
2021,0,0,33,0,-33
2022,0,0,106,0,-106
2023,0,0,11,0,-11
2024,1,0,48,0,-48
2025,1,0,6,0,-6
2026,0,0,90,0,-90
2027,1,0,88,0,-88
2028,1,0,44,0,-44
2029,1,0,8,0,-8
2030,0,0,24,0,-24
2031,1,1,67,1248,1181
2032,1,1,367,1725,1358
2033,0,0,29,0,-29
2034,1,1,603,1417,814
2035,0,0,1,0,-1
2036,0,0,12,0,-12
2037,1,0,11,0,-11
2038,1,0,43,0,-43
2039,1,0,15,0,-15
2040,0,0,33,0,-33
2041,1,0,19,0,-19
2042,1,0,15,0,-15
2043,0,0,162,0,-162
2044,1,1,1310,1230,-80
2045,0,0,19,0,-19
2046,1,1,1360,1783,423
2047,0,0,22,0,-22
2048,0,0,18,0,-18
2049,1,0,15,0,-15
2050,1,1,155,1531,1376
2051,1,0,57,0,-57
2052,1,1,440,1254,814
2053,1,0,2,0,-2
2054,0,0,76,0,-76
2055,1,1,470,1267,797
2056,1,1,74,1407,1333
2057,0,0,98,0,-98
2058,1,0,18,0,-18
2059,0,0,5,0,-5
2060,1,1,74,2189,2115
2061,0,0,22,0,-22
2062,0,0,18,0,-18
2063,0,0,37,0,-37
2064,1,1,992,2353,1361
2065,0,0,55,0,-55
2066,0,0,17,0,-17
2067,0,0,3,0,-3
2068,1,0,25,0,-25
2069,1,0,5,0,-5
2070,1,1,548,1256,708
2071,1,0,103,0,-103
2072,0,0,58,0,-58
2073,1,1,1356,1648,292
2074,0,0,69,0,-69
2075,1,0,20,0,-20
2076,1,0,48,0,-48
2077,1,0,99,0,-99
2078,0,0,93,0,-93
2079,1,0,38,0,-38
2080,0,0,310,0,-310
2081,0,0,41,0,-41
2082,0,0,277,0,-277
2083,1,1,58,1231,1173
2084,1,1,381,1205,824
2085,0,0,12,0,-12
2086,1,0,14,0,-14
2087,0,0,3,0,-3
2088,1,1,1533,2629,1096
2089,1,0,25,0,-25
2090,1,0,15,0,-15
2091,1,1,2580,1338,-1242
2092,0,0,82,0,-82
2093,1,1,395,1307,912
2094,0,0,7,0,-7
2095,1,1,596,1229,633
2096,0,0,108,0,-108
2097,0,0,70,0,-70
2098,1,1,79,1386,1307
2099,1,1,300,13974,13674
2100,1,1,303,1387,1084
2101,1,1,686,1337,651
2102,0,0,168,0,-168
2103,1,0,19,0,-19
2104,1,0,17,0,-17
2105,1,1,514,1486,972
2106,0,0,43,0,-43
2107,1,0,23,0,-23
2108,0,0,17,0,-17
2109,0,0,34,0,-34
2110,0,0,1,0,-1
2111,0,0,20,0,-20
2112,1,1,96,2697,2601
2113,1,0,54,0,-54
2114,0,0,269,0,-269
2115,0,0,97,0,-97
2116,0,0,28,0,-28
2117,1,0,170,0,-170
2118,1,0,77,0,-77
2119,1,0,3,0,-3
2120,1,0,5,0,-5
2121,0,0,145,0,-145
2122,0,0,27,0,-27
2123,0,0,181,0,-181
2124,0,0,3,0,-3
2125,0,0,36,0,-36
2126,1,0,42,0,-42
2127,1,0,41,0,-41
2128,1,1,210,1676,1466
2129,1,1,406,1822,1416
2130,1,0,63,0,-63
2131,1,1,113,1487,1374
2132,0,0,50,0,-50
2133,0,0,52,0,-52
2134,1,1,398,1567,1169
2135,1,0,14,0,-14
2136,1,1,290,1217,927
2137,0,0,26,0,-26
2138,1,0,4,0,-4
2139,1,1,405,1289,884
2140,0,0,51,0,-51
2141,1,1,90,1516,1426
2142,0,0,12,0,-12
2143,1,1,195,1471,1276
2144,0,0,83,0,-83
2145,1,0,44,0,-44
2146,1,0,42,0,-42
2147,0,0,8,0,-8
2148,1,0,123,0,-123
2149,1,1,590,1592,1002
2150,1,0,41,0,-41
2151,1,1,777,1265,488
2152,0,0,211,0,-211
2153,1,1,355,1298,943
2154,1,1,196,1564,1368
2155,1,1,143,1502,1359
2156,0,0,319,0,-319
2157,1,1,1377,1318,-59
2158,1,0,14,0,-14
2159,0,0,119,0,-119
2160,1,0,14,0,-14
2161,1,0,168,0,-168
2162,1,0,29,0,-29
2163,0,0,30,0,-30
2164,0,0,40,0,-40
2165,1,1,556,2866,2310
2166,0,0,11,0,-11
2167,1,1,231,2032,1801
2168,1,0,12,0,-12
2169,1,0,137,0,-137
2170,1,0,5,0,-5
2171,1,0,2,0,-2
2172,1,1,532,1211,679
2173,1,0,30,0,-30
2174,0,0,77,0,-77
2175,0,0,7,0,-7
2176,0,0,14,0,-14
2177,1,1,536,1209,673
2178,1,0,22,0,-22
2179,0,0,27,0,-27
2180,0,0,35,0,-35
2181,1,1,389,1218,829
2182,0,0,78,0,-78
2183,0,0,48,0,-48
2184,1,0,5,0,-5
2185,1,0,104,0,-104
2186,1,0,24,0,-24
2187,1,1,128,1339,1211
2188,0,0,65,0,-65
2189,1,0,12,0,-12
2190,0,0,29,0,-29
2191,0,0,15,0,-15
2192,1,1,1212,1279,67
2193,1,0,11,0,-11
2194,0,0,1,0,-1
2195,1,0,53,0,-53
2196,1,1,1250,2080,830
2197,1,1,61,1995,1934
2198,1,0,2,0,-2
2199,1,1,1054,1861,807
2200,1,0,49,0,-49
2201,1,1,872,1421,549
2202,1,1,329,1217,888
2203,1,1,588,2216,1628
2204,1,0,28,0,-28
2205,1,0,39,0,-39
2206,1,1,654,2467,1813
2207,1,0,0,0,0
2208,1,0,22,0,-22
2209,0,0,120,0,-120
2210,1,1,24,1521,1497
2211,1,0,56,0,-56
2212,0,0,55,0,-55
2213,0,0,28,0,-28
2214,1,0,3,0,-3
2215,0,0,73,0,-73
2216,0,0,32,0,-32
2217,1,1,77,1204,1127
2218,0,0,34,0,-34
2219,1,0,23,0,-23
2220,1,0,4,0,-4
2221,0,0,19,0,-19
2222,1,1,93,1491,1398
2223,0,0,3,0,-3
2224,1,0,0,0,0
2225,0,0,5,0,-5
2226,0,0,178,0,-178
2227,1,1,466,1395,929
2228,0,0,68,0,-68
2229,1,1,563,1567,1004
2230,0,0,104,0,-104
2231,0,0,8,0,-8
2232,1,0,4,0,-4
2233,0,0,22,0,-22
2234,0,0,84,0,-84
2235,1,1,193,1231,1038
2236,1,1,164,1222,1058
2237,1,1,139,1297,1158
2238,1,1,565,1255,690
2239,0,0,61,0,-61
2240,1,0,101,0,-101
2241,1,0,54,0,-54
2242,1,1,338,2392,2054
2243,1,1,345,1315,970
2244,1,0,32,0,-32
2245,0,0,70,0,-70
2246,1,0,24,0,-24
2247,0,0,33,0,-33
2248,0,0,7,0,-7
2249,1,1,1948,2795,847
2250,1,1,184,1523,1339
2251,1,1,1335,1217,-118
2252,1,1,281,1850,1569
2253,1,0,65,0,-65
2254,0,0,72,0,-72
2255,1,0,1,0,-1
2256,1,1,182,2008,1826
2257,1,1,100,1260,1160
2258,1,1,990,3131,2141
2259,1,1,852,1784,932
2260,0,0,61,0,-61
2261,1,1,1501,2054,553
2262,1,1,1270,1373,103
2263,0,0,20,0,-20
2264,1,0,39,0,-39
2265,0,0,15,0,-15
2266,1,1,654,1917,1263
2267,1,0,122,0,-122
2268,1,1,507,1278,771
2269,1,0,63,0,-63
2270,1,1,823,1228,405
2271,1,0,55,0,-55
2272,1,1,773,2438,1665
2273,1,0,5,0,-5
2274,1,0,18,0,-18
2275,1,0,28,0,-28
2276,1,1,907,2216,1309
2277,1,0,156,0,-156
2278,0,0,64,0,-64
2279,0,0,4,0,-4
2280,1,0,43,0,-43
2281,1,0,41,0,-41
2282,1,0,45,0,-45
2283,1,0,73,0,-73
2284,1,1,295,1689,1394
2285,0,0,198,0,-198
2286,1,0,67,0,-67
2287,1,0,5,0,-5
2288,1,1,138,1271,1133
2289,1,0,0,0,0
2290,0,0,45,0,-45
2291,0,0,29,0,-29
2292,0,0,1,0,-1
2293,0,0,8,0,-8
2294,1,1,1026,1234,208
2295,0,0,9,0,-9
2296,1,1,111,3017,2906
2297,0,0,25,0,-25
2298,1,0,82,0,-82
2299,1,0,98,0,-98
2300,1,0,2,0,-2
2301,0,0,58,0,-58
2302,1,1,476,1528,1052
2303,0,0,13,0,-13
2304,1,1,462,1836,1374
2305,0,0,62,0,-62
2306,1,0,1,0,-1
2307,1,1,189,1588,1399
2308,1,0,54,0,-54
2309,1,0,85,0,-85
2310,1,1,349,1259,910
2311,1,0,13,0,-13
2312,0,0,29,0,-29
2313,0,0,128,0,-128
2314,0,0,22,0,-22
2315,1,1,394,1647,1253
2316,0,0,21,0,-21
2317,1,1,554,1420,866
2318,1,1,26,1203,1177
2319,1,1,149,1234,1085
2320,1,1,182,1445,1263
2321,1,0,36,0,-36
2322,0,0,163,0,-163
2323,1,1,508,1927,1419
2324,1,1,751,1269,518
2325,0,0,0,0,0
2326,1,1,807,1329,522
2327,1,0,25,0,-25
2328,0,0,40,0,-40
2329,0,0,42,0,-42
2330,1,0,3,0,-3
2331,0,0,3,0,-3
2332,0,0,49,0,-49
2333,0,0,17,0,-17
2334,0,0,14,0,-14
2335,0,0,50,0,-50
2336,0,0,12,0,-12
2337,1,1,650,1526,876
2338,1,0,146,0,-146
2339,1,0,37,0,-37
2340,1,1,240,1289,1049
2341,0,0,68,0,-68
2342,1,1,60,1230,1170
2343,0,0,35,0,-35
2344,0,0,10,0,-10
2345,1,0,85,0,-85
2346,1,0,38,0,-38
2347,0,0,10,0,-10
2348,1,1,721,1320,599
2349,1,0,51,0,-51
2350,0,0,33,0,-33
2351,1,0,0,0,0
2352,0,0,26,0,-26
2353,0,0,14,0,-14
2354,0,0,212,0,-212
2355,1,0,27,0,-27
2356,0,0,0,0,0
2357,1,1,148,1212,1064
2358,1,0,28,0,-28
2359,0,0,42,0,-42
2360,1,1,1967,1936,-31
2361,0,0,39,0,-39
2362,1,0,4,0,-4
2363,1,0,85,0,-85
2364,1,1,417,1516,1099
2365,1,1,1404,1266,-138
2366,1,1,796,1452,656
2367,1,0,64,0,-64
2368,0,0,0,0,0
2369,0,0,24,0,-24
2370,1,1,463,1777,1314
2371,1,0,59,0,-59
2372,0,0,30,0,-30
2373,0,0,2,0,-2
2374,1,1,150,1909,1759
2375,1,0,107,0,-107
2376,1,1,374,1522,1148
2377,0,0,74,0,-74
2378,0,0,8,0,-8
2379,1,0,78,0,-78
2380,1,0,84,0,-84
2381,1,1,723,1278,555
2382,0,0,149,0,-149
2383,1,0,165,0,-165
2384,0,0,29,0,-29
2385,1,1,776,1203,427
2386,1,0,41,0,-41
2387,1,0,7,0,-7
2388,0,0,144,0,-144
2389,1,1,645,1784,1139
2390,1,0,14,0,-14
2391,1,1,2717,1635,-1082
2392,0,0,3,0,-3
2393,1,1,203,1457,1254
2394,0,0,30,0,-30
2395,1,0,58,0,-58
2396,1,1,122,1210,1088
2397,1,1,352,1663,1311
2398,1,0,7,0,-7
2399,0,0,152,0,-152
2400,1,1,494,1816,1322
2401,1,1,479,1631,1152
2402,1,1,342,1715,1373
2403,1,1,52,1305,1253
2404,0,0,79,0,-79
2405,0,0,87,0,-87
2406,1,0,57,0,-57
2407,1,0,79,0,-79
2408,1,0,18,0,-18
2409,1,1,33,1749,1716
2410,0,0,21,0,-21
2411,1,1,461,1492,1031
2412,1,0,4,0,-4
2413,0,0,30,0,-30
2414,1,0,167,0,-167
2415,0,0,2,0,-2
2416,1,0,153,0,-153
2417,1,0,69,0,-69
2418,0,0,87,0,-87
2419,0,0,75,0,-75
2420,0,0,32,0,-32
2421,0,0,118,0,-118
2422,1,0,6,0,-6
2423,0,0,118,0,-118
2424,0,0,6,0,-6
2425,1,0,77,0,-77
2426,1,1,307,2884,2577
2427,0,0,1,0,-1
2428,1,0,118,0,-118
2429,1,0,127,0,-127
2430,1,0,74,0,-74
2431,1,0,33,0,-33
2432,0,0,9,0,-9
2433,1,0,49,0,-49
2434,1,0,6,0,-6
2435,1,0,9,0,-9
2436,1,0,1,0,-1
2437,0,0,12,0,-12
2438,1,0,22,0,-22
2439,0,0,44,0,-44
2440,0,0,38,0,-38
2441,1,0,108,0,-108
2442,1,1,909,1591,682
2443,0,0,28,0,-28
2444,1,1,451,1244,793
2445,1,0,1,0,-1
2446,0,0,5,0,-5
2447,0,0,5,0,-5
2448,1,0,12,0,-12
2449,0,0,27,0,-27
2450,0,0,47,0,-47
2451,1,0,38,0,-38
2452,0,0,6,0,-6
2453,1,0,162,0,-162
2454,0,0,8,0,-8
2455,0,0,52,0,-52
2456,1,0,48,0,-48
2457,1,1,83,1441,1358
2458,1,1,335,1837,1502
2459,0,0,74,0,-74
2460,1,1,771,1410,639
2461,1,0,36,0,-36
2462,0,0,14,0,-14
2463,0,0,14,0,-14
2464,0,0,101,0,-101
2465,0,0,1,0,-1
2466,0,0,6,0,-6
2467,0,0,22,0,-22
2468,0,0,143,0,-143
2469,1,1,379,1256,877
2470,1,1,378,1599,1221
2471,1,1,149,2108,1959
2472,1,1,129,1321,1192
2473,1,0,142,0,-142
2474,0,0,31,0,-31
2475,1,1,697,1307,610
2476,1,0,65,0,-65
2477,0,0,40,0,-40
2478,0,0,88,0,-88
2479,1,1,93,2251,2158
2480,1,1,67,1270,1203
2481,1,1,282,1565,1283
2482,1,1,425,1256,831
2483,0,0,94,0,-94
2484,0,0,65,0,-65
2485,0,0,121,0,-121
2486,1,0,18,0,-18
2487,1,1,1065,1294,229
2488,1,0,57,0,-57
2489,1,0,114,0,-114
2490,1,0,19,0,-19
2491,0,0,0,0,0
2492,0,0,83,0,-83
2493,0,0,43,0,-43
2494,1,1,206,1275,1069
2495,1,0,48,0,-48
2496,1,1,158,1335,1177
2497,1,0,58,0,-58
2498,0,0,34,0,-34
2499,0,0,4,0,-4
2500,1,0,73,0,-73
2501,0,0,70,0,-70
2502,1,1,211,1582,1371
2503,0,0,64,0,-64
2504,1,1,29,1361,1332
2505,0,0,25,0,-25
2506,0,0,58,0,-58
2507,1,0,15,0,-15
2508,0,0,18,0,-18
2509,1,1,45,1435,1390
2510,1,0,22,0,-22
2511,0,0,42,0,-42
2512,1,1,423,1702,1279
2513,0,0,0,0,0
2514,1,0,31,0,-31
2515,0,0,38,0,-38
2516,0,0,45,0,-45
2517,1,1,942,1518,576
2518,1,0,53,0,-53
2519,1,0,39,0,-39
2520,0,0,11,0,-11
2521,1,0,21,0,-21
2522,1,1,77,1391,1314
2523,0,0,0,0,0
2524,0,0,4,0,-4
2525,1,0,17,0,-17
2526,1,0,46,0,-46
2527,0,0,59,0,-59
2528,1,1,1435,2485,1050
2529,0,0,92,0,-92
2530,1,1,857,1315,458
2531,1,1,774,1291,517
2532,1,0,36,0,-36
2533,0,0,1,0,-1
2534,1,1,1227,1247,20
2535,1,0,39,0,-39
2536,1,0,20,0,-20
2537,1,0,32,0,-32
2538,1,0,23,0,-23
2539,0,0,62,0,-62
2540,1,0,39,0,-39
2541,1,0,75,0,-75
2542,0,0,60,0,-60
2543,1,0,149,0,-149
2544,1,0,70,0,-70
2545,0,0,38,0,-38
2546,1,1,26,1347,1321
2547,1,1,295,1387,1092
2548,1,0,62,0,-62
2549,0,0,45,0,-45
2550,1,1,156,1293,1137
2551,1,0,27,0,-27
2552,0,0,16,0,-16
2553,1,0,45,0,-45
2554,0,0,9,0,-9
2555,0,0,47,0,-47
2556,1,1,437,1218,781
2557,1,1,322,1584,1262
2558,0,0,57,0,-57
2559,1,1,581,2012,1431
2560,1,0,11,0,-11
2561,1,1,249,1397,1148
2562,1,1,834,1695,861
2563,1,0,74,0,-74
2564,0,0,5,0,-5
2565,1,1,1011,1528,517
2566,1,1,168,1692,1524
2567,0,0,57,0,-57
2568,1,0,85,0,-85
2569,0,0,96,0,-96
2570,0,0,76,0,-76
2571,0,0,4,0,-4
2572,1,1,296,1929,1633
2573,1,1,1016,1248,232
2574,0,0,1,0,-1
2575,1,1,185,1207,1022
2576,0,0,40,0,-40
2577,0,0,3,0,-3
2578,1,0,64,0,-64
2579,1,0,1,0,-1
2580,1,1,841,1657,816
2581,1,1,145,1308,1163
2582,1,1,367,1381,1014
2583,0,0,13,0,-13
2584,1,0,40,0,-40
2585,0,0,9,0,-9
2586,0,0,22,0,-22
2587,1,0,22,0,-22
2588,1,1,225,1888,1663
2589,1,1,693,1900,1207
2590,0,0,28,0,-28
2591,0,0,150,0,-150
2592,1,0,147,0,-147
2593,0,0,20,0,-20
2594,1,0,68,0,-68
2595,0,0,47,0,-47
2596,0,0,9,0,-9
2597,1,1,235,1240,1005
2598,1,1,827,2010,1183
2599,0,0,157,0,-157
2600,0,0,135,0,-135
2601,1,0,78,0,-78
2602,1,1,728,1712,984
2603,1,0,10,0,-10
2604,0,0,77,0,-77
2605,1,1,690,1807,1117
2606,0,0,49,0,-49
2607,0,0,10,0,-10
2608,1,0,89,0,-89
2609,0,0,4,0,-4
2610,1,0,11,0,-11
2611,1,1,314,1994,1680
2612,1,1,92,1436,1344
2613,0,0,32,0,-32
2614,0,0,5,0,-5
2615,1,1,219,1206,987
2616,1,0,83,0,-83
2617,1,0,53,0,-53
2618,1,1,285,1256,971
2619,0,0,50,0,-50
2620,1,1,423,1451,1028
2621,0,0,146,0,-146
2622,1,1,245,1586,1341
2623,1,1,103,1367,1264
2624,1,1,375,1384,1009
2625,1,0,35,0,-35
2626,1,0,46,0,-46
2627,1,1,1057,1447,390
2628,0,0,52,0,-52
2629,1,1,616,2125,1509
2630,1,1,909,1802,893
2631,1,0,0,0,0
2632,1,1,586,1447,861
2633,1,1,448,1223,775
2634,1,1,1004,1545,541
2635,0,0,7,0,-7
2636,1,0,2,0,-2
2637,1,1,1003,2388,1385
2638,0,0,14,0,-14
2639,1,0,6,0,-6
2640,0,0,41,0,-41
2641,1,0,59,0,-59
2642,1,0,63,0,-63
2643,0,0,56,0,-56
2644,0,0,25,0,-25
2645,0,0,105,0,-105
2646,1,0,67,0,-67
2647,1,0,52,0,-52
2648,0,0,126,0,-126
2649,1,0,76,0,-76
2650,1,1,462,1685,1223
2651,0,0,76,0,-76
2652,1,0,38,0,-38
2653,1,0,62,0,-62
2654,1,1,1311,1220,-91
2655,1,0,38,0,-38
2656,1,0,6,0,-6
2657,1,1,329,1249,920
2658,1,0,24,0,-24
2659,0,0,2,0,-2
2660,0,0,35,0,-35
2661,1,0,18,0,-18
2662,1,1,193,1681,1488
2663,1,0,10,0,-10
2664,0,0,21,0,-21
2665,1,0,71,0,-71
2666,1,0,62,0,-62
2667,1,1,163,2313,2150
2668,1,1,219,1705,1486
2669,0,0,86,0,-86
2670,0,0,22,0,-22
2671,1,1,972,1485,513
2672,0,0,5,0,-5
2673,0,0,33,0,-33
2674,0,0,16,0,-16
2675,1,0,30,0,-30
2676,1,1,1987,1392,-595
2677,1,1,391,1209,818
2678,0,0,16,0,-16
2679,0,0,76,0,-76
2680,1,1,144,1618,1474
2681,1,0,12,0,-12
2682,0,0,59,0,-59
2683,0,0,33,0,-33
2684,0,0,14,0,-14
2685,0,0,23,0,-23
2686,1,0,203,0,-203
2687,1,0,42,0,-42
2688,1,1,579,2889,2310
2689,1,0,19,0,-19
2690,1,0,85,0,-85
2691,1,1,1548,1345,-203
2692,1,0,7,0,-7
2693,1,0,33,0,-33
2694,1,0,11,0,-11
2695,1,0,9,0,-9
2696,0,0,73,0,-73
2697,0,0,5,0,-5
2698,1,1,88,1644,1556
2699,0,0,15,0,-15
2700,1,0,121,0,-121
2701,1,0,2,0,-2
2702,1,1,359,1614,1255
2703,1,1,1196,1386,190
2704,1,0,3,0,-3
2705,1,1,439,1247,808
2706,1,1,1102,1486,384
2707,1,1,502,1264,762
2708,0,0,8,0,-8
2709,1,0,99,0,-99
2710,1,1,203,1457,1254
2711,0,0,33,0,-33
2712,0,0,145,0,-145
2713,1,0,37,0,-37
2714,1,0,0,0,0
2715,0,0,50,0,-50
2716,0,0,20,0,-20
2717,1,0,43,0,-43
2718,0,0,10,0,-10
2719,0,0,33,0,-33
2720,1,1,181,1244,1063
2721,1,1,717,1449,732
2722,1,0,48,0,-48
2723,0,0,17,0,-17
2724,1,0,54,0,-54
2725,1,0,27,0,-27
2726,0,0,8,0,-8
2727,1,0,27,0,-27
2728,0,0,162,0,-162
2729,1,1,90,1360,1270
2730,1,0,10,0,-10
2731,1,0,22,0,-22
2732,0,0,36,0,-36
2733,0,0,17,0,-17
2734,0,0,119,0,-119
2735,1,0,34,0,-34
2736,0,0,42,0,-42
2737,0,0,10,0,-10
2738,0,0,20,0,-20
2739,1,0,2,0,-2
2740,0,0,31,0,-31
2741,1,0,17,0,-17
2742,0,0,107,0,-107
2743,1,1,475,1963,1488
2744,1,0,30,0,-30
2745,1,0,49,0,-49
2746,0,0,0,0,0
2747,1,1,521,1783,1262
2748,0,0,14,0,-14
2749,0,0,32,0,-32
2750,0,0,23,0,-23
2751,0,0,12,0,-12
2752,1,1,1086,2163,1077
2753,1,0,52,0,-52
2754,1,1,162,4320,4158
2755,1,0,31,0,-31
2756,0,0,87,0,-87
2757,1,0,75,0,-75
2758,0,0,9,0,-9
2759,1,0,2,0,-2
2760,1,1,277,1504,1227
2761,1,1,1573,1921,348
2762,0,0,108,0,-108
2763,0,0,193,0,-193
2764,0,0,62,0,-62
2765,1,1,239,1767,1528
2766,0,0,58,0,-58
2767,0,0,173,0,-173
2768,1,1,518,1281,763
2769,0,0,62,0,-62
2770,1,0,79,0,-79
2771,0,0,21,0,-21
2772,1,0,17,0,-17
2773,0,0,65,0,-65
2774,1,1,1383,1227,-156
2775,0,0,78,0,-78
2776,1,0,1,0,-1
2777,1,1,136,1214,1078
2778,0,0,45,0,-45
2779,1,0,45,0,-45
2780,1,1,2028,1204,-824
2781,1,0,19,0,-19
2782,0,0,26,0,-26
2783,0,0,85,0,-85
2784,1,1,412,1354,942
2785,0,0,17,0,-17
2786,1,0,22,0,-22
2787,0,0,8,0,-8
2788,0,0,8,0,-8
2789,1,1,70,1437,1367
2790,1,1,65,1363,1298
2791,0,0,295,0,-295
2792,1,1,395,1395,1000
2793,0,0,44,0,-44
2794,1,0,97,0,-97
2795,0,0,80,0,-80
2796,0,0,91,0,-91
2797,1,0,50,0,-50
2798,0,0,3,0,-3
2799,0,0,31,0,-31
2800,0,0,69,0,-69
2801,1,0,74,0,-74
2802,1,0,57,0,-57
2803,1,1,584,1667,1083
2804,1,0,51,0,-51
2805,1,0,81,0,-81
2806,1,0,229,0,-229
2807,1,1,356,1592,1236
2808,0,0,29,0,-29
2809,1,1,369,2001,1632
2810,1,1,341,1699,1358
2811,1,0,31,0,-31
2812,1,1,90,1299,1209
2813,0,0,22,0,-22
2814,0,0,7,0,-7
2815,0,0,8,0,-8
2816,0,0,161,0,-161
2817,1,0,90,0,-90
2818,1,1,42,1826,1784
2819,0,0,60,0,-60
2820,1,0,16,0,-16
2821,0,0,7,0,-7
2822,1,1,72,1203,1131
2823,1,0,24,0,-24
2824,1,1,1358,1928,570
2825,1,0,74,0,-74
2826,0,0,118,0,-118
2827,1,1,437,1708,1271
2828,1,1,550,1256,706
2829,0,0,0,0,0
2830,1,1,954,1891,937
2831,1,1,1374,1441,67
2832,1,0,34,0,-34
2833,0,0,87,0,-87
2834,1,1,216,1265,1049
2835,0,0,43,0,-43
2836,0,0,117,0,-117
2837,1,1,259,1414,1155
2838,1,1,24,1357,1333
2839,0,0,119,0,-119
2840,1,1,74,1236,1162
2841,1,0,28,0,-28
2842,1,0,185,0,-185
2843,1,1,172,2952,2780
2844,0,0,2,0,-2
2845,1,0,39,0,-39
2846,1,1,764,1228,464
2847,1,0,4,0,-4
2848,1,1,23,1513,1490
2849,0,0,9,0,-9
2850,0,0,35,0,-35
2851,0,0,34,0,-34
2852,0,0,13,0,-13
2853,1,0,53,0,-53
2854,1,0,21,0,-21
2855,0,0,70,0,-70
2856,1,0,38,0,-38
2857,1,0,11,0,-11
2858,1,0,54,0,-54
2859,0,0,3,0,-3
2860,1,0,28,0,-28
2861,1,1,388,1347,959
2862,0,0,33,0,-33
2863,1,0,90,0,-90
2864,1,0,22,0,-22
2865,0,0,55,0,-55
2866,0,0,26,0,-26
2867,0,0,79,0,-79
2868,0,0,48,0,-48
2869,0,0,31,0,-31
2870,0,0,19,0,-19
2871,0,0,70,0,-70
2872,1,0,13,0,-13
2873,1,0,64,0,-64
2874,1,1,1635,1228,-407
2875,1,1,468,1615,1147
2876,1,0,1,0,-1
2877,1,0,188,0,-188
2878,0,0,22,0,-22
2879,1,1,444,1204,760
2880,0,0,78,0,-78
2881,1,0,37,0,-37
2882,1,0,12,0,-12
2883,1,1,612,2276,1664
2884,1,1,325,1366,1041
2885,1,0,13,0,-13
2886,1,1,381,1271,890
2887,1,0,11,0,-11
2888,1,1,679,1232,553
2889,1,1,73,1215,1142
2890,1,1,136,1204,1068
2891,0,0,70,0,-70
2892,1,0,39,0,-39
2893,1,1,397,3166,2769
2894,0,0,18,0,-18
2895,0,0,37,0,-37
2896,0,0,55,0,-55
2897,1,1,177,1247,1070
2898,1,1,562,1333,771
2899,0,0,8,0,-8
2900,0,0,50,0,-50
2901,1,1,655,1383,728
2902,1,1,669,1216,547
2903,0,0,24,0,-24
2904,1,0,17,0,-17
2905,0,0,96,0,-96
2906,1,0,25,0,-25
2907,0,0,0,0,0
2908,0,0,47,0,-47
2909,1,0,17,0,-17
2910,0,0,37,0,-37
2911,1,0,6,0,-6
2912,1,0,63,0,-63
2913,1,0,62,0,-62
2914,0,0,54,0,-54
2915,1,0,32,0,-32
2916,1,0,235,0,-235
2917,0,0,97,0,-97
2918,0,0,132,0,-132
2919,0,0,88,0,-88
2920,1,0,36,0,-36
2921,0,0,8,0,-8
2922,0,0,122,0,-122
2923,1,1,255,1675,1420
2924,0,0,129,0,-129
2925,1,0,24,0,-24
2926,1,1,1901,1388,-513
2927,0,0,9,0,-9
2928,0,0,20,0,-20
2929,1,0,33,0,-33
2930,1,1,473,1532,1059
2931,1,0,70,0,-70
2932,1,1,979,1510,531
2933,1,0,10,0,-10
2934,1,1,184,1364,1180
2935,1,1,115,1647,1532
2936,1,1,167,2677,2510
2937,1,1,1970,1257,-713
2938,0,0,96,0,-96
2939,1,1,725,1308,583
2940,0,0,22,0,-22
2941,0,0,14,0,-14
2942,1,1,116,1227,1111
2943,1,1,81,1299,1218
2944,0,0,51,0,-51
2945,1,0,123,0,-123
2946,0,0,35,0,-35
2947,1,1,304,1295,991
2948,1,1,82,2514,2432
2949,1,1,266,1398,1132
2950,0,0,4,0,-4
2951,0,0,18,0,-18
2952,1,0,123,0,-123
2953,1,0,38,0,-38
2954,1,0,68,0,-68
2955,0,0,103,0,-103
2956,1,1,311,1277,966
2957,0,0,16,0,-16
2958,1,1,1008,1733,725
2959,1,1,311,1460,1149
2960,1,0,30,0,-30
2961,1,0,18,0,-18
2962,1,0,42,0,-42
2963,1,1,286,1333,1047
2964,0,0,38,0,-38
2965,1,0,8,0,-8
2966,1,0,43,0,-43
2967,1,1,195,1250,1055
2968,1,1,146,1626,1480
2969,1,1,505,1240,735
2970,0,0,91,0,-91
2971,0,0,10,0,-10
2972,1,0,6,0,-6
2973,1,0,103,0,-103
2974,1,1,428,1296,868
2975,0,0,125,0,-125
2976,0,0,69,0,-69
2977,0,0,98,0,-98
2978,1,1,1979,1202,-777
2979,1,0,65,0,-65
2980,0,0,19,0,-19
2981,1,1,1641,1248,-393
2982,0,0,76,0,-76
2983,0,0,12,0,-12
2984,1,1,571,1848,1277
2985,0,0,63,0,-63
2986,1,0,1,0,-1
2987,1,0,33,0,-33
2988,1,1,470,1580,1110
2989,1,0,33,0,-33
2990,0,0,52,0,-52
2991,1,0,138,0,-138
2992,1,1,1265,1326,61
2993,1,1,537,2151,1614
2994,1,0,14,0,-14
2995,0,0,26,0,-26
2996,0,0,6,0,-6
2997,1,0,170,0,-170
2998,1,0,25,0,-25
2999,1,1,309,1221,912
3000,0,0,10,0,-10
3001,1,1,652,1436,784
3002,0,0,109,0,-109
3003,0,0,46,0,-46
3004,0,0,0,0,0
3005,1,0,187,0,-187
3006,0,0,127,0,-127
3007,0,0,10,0,-10
3008,0,0,24,0,-24
3009,0,0,18,0,-18
3010,1,0,56,0,-56
3011,0,0,151,0,-151
3012,1,1,420,1241,821
3013,0,0,48,0,-48
3014,1,1,1667,1847,180
3015,0,0,126,0,-126
3016,1,0,31,0,-31
3017,0,0,0,0,0
3018,0,0,11,0,-11
3019,1,1,332,1561,1229
3020,0,0,42,0,-42
3021,0,0,4,0,-4
3022,0,0,87,0,-87
3023,1,1,528,1468,940
3024,1,0,13,0,-13
3025,1,0,12,0,-12
3026,1,0,30,0,-30
3027,0,0,5,0,-5
3028,0,0,2,0,-2
3029,1,1,124,1211,1087
3030,1,1,811,1273,462
3031,0,0,61,0,-61
3032,0,0,5,0,-5
3033,0,0,13,0,-13
3034,1,0,61,0,-61
3035,0,0,16,0,-16
3036,1,1,472,1551,1079
3037,0,0,39,0,-39
3038,1,0,30,0,-30
3039,0,0,22,0,-22
3040,1,1,935,1237,302
3041,0,0,14,0,-14
3042,1,1,482,2413,1931
3043,0,0,15,0,-15
3044,0,0,66,0,-66
3045,1,0,97,0,-97
3046,0,0,16,0,-16
3047,1,1,467,1485,1018
3048,1,1,528,1858,1330
3049,1,0,63,0,-63
3050,0,0,4,0,-4
3051,0,0,65,0,-65
3052,1,1,478,1323,845
3053,0,0,95,0,-95
3054,1,0,57,0,-57
3055,0,0,12,0,-12
3056,1,0,69,0,-69
3057,1,1,302,1272,970
3058,0,0,33,0,-33
3059,0,0,106,0,-106
3060,0,0,3,0,-3
3061,0,0,42,0,-42
3062,1,0,12,0,-12
3063,1,0,40,0,-40
3064,0,0,224,0,-224
3065,0,0,41,0,-41
3066,0,0,6,0,-6
3067,1,1,795,1817,1022
3068,1,1,97,1576,1479
3069,0,0,148,0,-148
3070,0,0,94,0,-94
3071,1,1,44,2542,2498
3072,0,0,123,0,-123
3073,1,1,114,2260,2146
3074,0,0,85,0,-85
3075,1,0,180,0,-180
3076,1,1,1252,1342,90
3077,1,0,1,0,-1
3078,1,1,109,1378,1269
3079,1,0,184,0,-184
3080,1,0,42,0,-42
3081,0,0,4,0,-4
3082,1,1,99,1311,1212
3083,0,0,117,0,-117
3084,1,0,21,0,-21
3085,1,0,8,0,-8
3086,1,0,1,0,-1
3087,0,0,6,0,-6
3088,0,0,35,0,-35
3089,1,1,951,1462,511
3090,1,0,10,0,-10
3091,1,1,405,1215,810
3092,0,0,43,0,-43
3093,0,0,22,0,-22
3094,1,0,75,0,-75
3095,1,0,17,0,-17
3096,1,0,17,0,-17
3097,0,0,59,0,-59
3098,1,0,87,0,-87
3099,1,0,45,0,-45
3100,0,0,60,0,-60
3101,1,0,81,0,-81
3102,0,0,24,0,-24
3103,1,0,37,0,-37
3104,0,0,66,0,-66
3105,1,0,22,0,-22
3106,0,0,227,0,-227
3107,1,1,1413,1296,-117
3108,1,0,79,0,-79
3109,0,0,1,0,-1
3110,0,0,54,0,-54
3111,0,0,363,0,-363
3112,1,0,70,0,-70
3113,0,0,91,0,-91
3114,1,0,110,0,-110
3115,1,1,301,1655,1354
3116,1,0,6,0,-6
3117,0,0,2,0,-2
3118,0,0,38,0,-38
3119,0,0,36,0,-36
3120,0,0,36,0,-36
3121,0,0,46,0,-46
3122,1,1,510,1599,1089
3123,1,0,10,0,-10
3124,1,1,631,1245,614
3125,1,1,466,1254,788
3126,1,1,495,1289,794
3127,0,0,26,0,-26
3128,0,0,31,0,-31
3129,0,0,122,0,-122
3130,1,1,806,9488,8682
3131,1,1,717,1300,583
3132,0,0,75,0,-75
3133,1,1,476,1280,804
3134,0,0,4,0,-4
3135,0,0,104,0,-104
3136,1,1,367,1224,857
3137,1,0,40,0,-40
3138,1,0,7,0,-7
3139,1,1,516,1417,901
3140,0,0,65,0,-65
3141,0,0,1,0,-1
3142,1,1,161,1647,1486
3143,0,0,4,0,-4
3144,0,0,50,0,-50
3145,1,1,45,1273,1228
3146,0,0,131,0,-131
3147,0,0,5,0,-5
3148,1,1,687,1206,519
3149,1,0,32,0,-32
3150,0,0,13,0,-13
3151,1,0,5,0,-5
3152,1,0,49,0,-49
3153,1,0,35,0,-35
3154,1,0,39,0,-39
3155,1,0,12,0,-12
3156,0,0,1,0,-1
3157,1,0,32,0,-32
3158,1,1,120,1648,1528
3159,0,0,228,0,-228
3160,1,0,1,0,-1
3161,0,0,5,0,-5
3162,0,0,86,0,-86
3163,0,0,22,0,-22
3164,1,1,481,1732,1251
3165,1,1,232,1230,998
3166,1,1,250,1289,1039
3167,0,0,14,0,-14
3168,0,0,49,0,-49
3169,0,0,3,0,-3
3170,0,0,2,0,-2
3171,0,0,70,0,-70
3172,1,1,130,1205,1075
3173,1,1,1013,1407,394
3174,0,0,48,0,-48
3175,0,0,47,0,-47
3176,1,1,469,1404,935
3177,1,0,36,0,-36
3178,0,0,39,0,-39
3179,1,1,793,1530,737
3180,1,1,401,1261,860
3181,1,0,31,0,-31
3182,0,0,53,0,-53
3183,0,0,28,0,-28
3184,1,1,74,1221,1147
3185,1,1,560,1262,702
3186,1,0,6,0,-6
3187,0,0,83,0,-83
3188,1,1,705,1211,506
3189,0,0,39,0,-39
3190,1,0,63,0,-63
3191,0,0,83,0,-83
3192,1,1,449,1209,760
3193,1,1,1002,1665,663
3194,1,1,185,1274,1089
3195,0,0,18,0,-18
3196,1,1,384,1593,1209
3197,1,1,209,1379,1170
3198,0,0,1,0,-1
3199,0,0,34,0,-34
3200,1,1,1361,1323,-38
3201,1,1,524,1272,748
3202,1,0,32,0,-32
3203,1,1,333,1290,957
3204,0,0,16,0,-16
3205,1,1,542,1259,717
3206,0,0,94,0,-94
3207,1,0,9,0,-9
3208,0,0,111,0,-111
3209,1,1,68,1543,1475
3210,0,0,12,0,-12
3211,0,0,14,0,-14
3212,1,1,524,1258,734
3213,0,0,7,0,-7
3214,1,1,1040,1518,478
3215,1,1,537,1214,677
3216,0,0,42,0,-42
3217,1,0,33,0,-33
3218,0,0,124,0,-124
3219,0,0,32,0,-32
3220,1,1,343,1283,940
3221,1,0,124,0,-124
3222,1,0,4,0,-4
3223,0,0,35,0,-35
3224,1,1,578,1460,882
3225,1,0,5,0,-5
3226,0,0,36,0,-36
3227,1,0,97,0,-97
3228,0,0,9,0,-9
3229,1,1,1708,1449,-259
3230,0,0,5,0,-5
3231,1,1,111,1221,1110
3232,1,1,209,2816,2607
3233,1,0,200,0,-200
3234,0,0,31,0,-31
3235,1,1,442,1429,987
3236,0,0,1,0,-1
3237,1,1,492,2021,1529
3238,1,1,367,1687,1320
3239,0,0,1,0,-1
3240,0,0,210,0,-210
3241,0,0,85,0,-85
3242,1,0,1,0,-1
3243,0,0,38,0,-38
3244,1,1,1573,1398,-175
3245,0,0,33,0,-33
3246,1,0,27,0,-27
3247,1,1,215,1600,1385
3248,1,1,1484,1306,-178
3249,1,1,209,4319,4110
3250,0,0,41,0,-41
3251,0,0,31,0,-31
3252,1,1,475,1402,927
3253,0,0,81,0,-81
3254,1,0,11,0,-11
3255,1,1,85,1349,1264
3256,1,0,10,0,-10
3257,1,0,1,0,-1
3258,1,0,38,0,-38
3259,1,1,524,1410,886
3260,0,0,3,0,-3
3261,1,1,358,1326,968
3262,0,0,53,0,-53
3263,1,0,2,0,-2
3264,0,0,72,0,-72
3265,1,0,24,0,-24
3266,1,1,464,1236,772
3267,0,0,55,0,-55
3268,0,0,51,0,-51
3269,1,0,57,0,-57
3270,0,0,7,0,-7
3271,1,0,58,0,-58
3272,1,0,39,0,-39
3273,1,0,24,0,-24
3274,1,1,74,1372,1298
3275,0,0,11,0,-11
3276,1,1,1140,3281,2141
3277,0,0,91,0,-91
3278,0,0,79,0,-79
3279,0,0,138,0,-138
3280,1,0,2,0,-2
3281,1,1,1392,1277,-115
3282,0,0,61,0,-61
3283,1,1,398,3818,3420
3284,1,0,127,0,-127
3285,0,0,50,0,-50
3286,0,0,68,0,-68
3287,1,0,11,0,-11
3288,0,0,152,0,-152
3289,0,0,95,0,-95
3290,0,0,9,0,-9
3291,1,0,3,0,-3
3292,1,1,215,1458,1243
3293,1,1,166,1385,1219
3294,1,0,82,0,-82
3295,1,0,2,0,-2
3296,1,1,192,1527,1335
3297,1,1,24,1940,1916
3298,1,0,18,0,-18
3299,0,0,5,0,-5
3300,0,0,93,0,-93
3301,0,0,31,0,-31
3302,1,1,23,1366,1343
3303,0,0,24,0,-24
3304,0,0,5,0,-5
3305,1,1,740,2400,1660
3306,1,0,118,0,-118
3307,0,0,216,0,-216
3308,1,1,203,1254,1051
3309,1,0,49,0,-49
3310,1,0,17,0,-17
3311,0,0,23,0,-23
3312,0,0,74,0,-74
3313,1,0,17,0,-17
3314,1,1,675,1260,585
3315,1,1,93,1235,1142
3316,0,0,136,0,-136
3317,1,0,55,0,-55
3318,1,0,80,0,-80
3319,1,0,99,0,-99
3320,1,0,55,0,-55
3321,0,0,29,0,-29
3322,0,0,54,0,-54
3323,1,1,54,1238,1184
3324,1,1,559,1861,1302
3325,0,0,12,0,-12
3326,0,0,90,0,-90
3327,1,0,43,0,-43
3328,0,0,5,0,-5
3329,0,0,2,0,-2
3330,0,0,161,0,-161
3331,1,1,1317,1409,92
3332,0,0,87,0,-87
3333,1,1,390,1232,842
3334,1,1,1687,1841,154
3335,1,1,5,1556,1551
3336,1,0,131,0,-131
3337,1,0,29,0,-29
3338,1,0,26,0,-26
3339,1,1,471,1864,1393
3340,0,0,19,0,-19
3341,1,1,77,1303,1226
3342,1,1,1284,1836,552
3343,1,0,54,0,-54
3344,0,0,5,0,-5
3345,0,0,16,0,-16
3346,0,0,91,0,-91
3347,0,0,99,0,-99
3348,1,1,187,1462,1275
3349,0,0,14,0,-14
3350,1,1,1752,2206,454
3351,1,1,420,1365,945
3352,0,0,42,0,-42
3353,0,0,23,0,-23
3354,0,0,58,0,-58
3355,1,0,57,0,-57
3356,0,0,247,0,-247
3357,0,0,19,0,-19
3358,0,0,11,0,-11
3359,0,0,63,0,-63
3360,0,0,19,0,-19
3361,1,0,115,0,-115
3362,1,0,51,0,-51
3363,0,0,39,0,-39
3364,0,0,27,0,-27
3365,1,0,10,0,-10
3366,0,0,35,0,-35
3367,1,0,127,0,-127
3368,0,0,2,0,-2
3369,0,0,24,0,-24
3370,1,0,93,0,-93
3371,1,0,112,0,-112
3372,0,0,5,0,-5
3373,1,0,83,0,-83
3374,1,1,461,1413,952
3375,0,0,40,0,-40
3376,0,0,96,0,-96
3377,0,0,43,0,-43
3378,0,0,10,0,-10
3379,1,1,192,1258,1066
3380,0,0,10,0,-10
3381,1,0,169,0,-169
3382,1,0,11,0,-11
3383,0,0,99,0,-99
3384,1,0,5,0,-5
3385,1,1,791,1388,597
3386,1,0,19,0,-19
3387,1,0,60,0,-60
3388,0,0,62,0,-62
3389,1,1,567,1413,846
3390,1,0,89,0,-89
3391,0,0,5,0,-5
3392,1,1,958,1362,404
3393,1,1,950,1531,581
3394,1,1,710,1298,588
3395,1,0,35,0,-35
3396,0,0,71,0,-71
3397,1,0,31,0,-31
3398,0,0,2,0,-2
3399,0,0,56,0,-56
3400,1,0,3,0,-3
3401,1,1,829,1544,715
3402,0,0,29,0,-29
3403,0,0,60,0,-60
3404,0,0,160,0,-160
3405,0,0,18,0,-18
3406,0,0,61,0,-61
3407,1,1,567,4594,4027
3408,1,1,281,1484,1203
3409,1,0,77,0,-77
3410,0,0,119,0,-119
3411,1,0,33,0,-33
3412,1,1,692,2849,2157
3413,1,1,670,1445,775
3414,1,0,54,0,-54
3415,1,1,480,1251,771
3416,0,0,67,0,-67
3417,0,0,0,0,0
3418,0,0,17,0,-17
3419,0,0,5,0,-5
3420,1,1,151,1237,1086
3421,1,1,472,1243,771
3422,0,0,18,0,-18
3423,1,1,1274,1382,108
3424,0,0,41,0,-41
3425,0,0,2,0,-2
3426,1,0,78,0,-78
3427,1,1,516,2043,1527
3428,0,0,9,0,-9
3429,1,1,309,1244,935
3430,0,0,24,0,-24
3431,1,1,1014,1214,200
3432,0,0,24,0,-24
3433,0,0,31,0,-31
3434,1,1,334,1442,1108
3435,0,0,73,0,-73
3436,1,1,650,2395,1745
3437,1,1,419,1334,915
3438,1,0,60,0,-60
3439,0,0,18,0,-18
3440,0,0,75,0,-75
3441,1,0,15,0,-15
3442,1,0,22,0,-22
3443,1,0,16,0,-16
3444,1,0,46,0,-46
3445,1,0,25,0,-25
3446,1,0,23,0,-23
3447,1,1,2200,1236,-964
3448,0,0,5,0,-5
3449,1,0,116,0,-116
3450,1,1,1012,1408,396
3451,1,1,190,1510,1320
3452,0,0,17,0,-17
3453,1,1,135,1477,1342
3454,0,0,47,0,-47
3455,1,0,16,0,-16
3456,1,1,118,1261,1143
3457,1,0,63,0,-63
3458,0,0,21,0,-21
3459,1,0,22,0,-22
3460,1,1,1332,1522,190
3461,1,0,9,0,-9
3462,1,0,111,0,-111
3463,1,1,61,1327,1266
3464,0,0,30,0,-30
3465,1,0,38,0,-38
3466,1,1,268,2024,1756
3467,1,0,108,0,-108
3468,1,0,12,0,-12
3469,0,0,60,0,-60
3470,0,0,43,0,-43
3471,1,1,1156,1253,97
3472,0,0,104,0,-104
3473,1,1,3277,3765,488
3474,1,1,1065,1213,148
3475,0,0,39,0,-39
3476,1,0,50,0,-50
3477,0,0,27,0,-27
3478,0,0,21,0,-21
3479,1,0,23,0,-23
3480,1,1,775,1283,508
3481,1,1,129,1278,1149
3482,1,0,29,0,-29
3483,0,0,29,0,-29
3484,1,1,50,2579,2529
3485,1,0,39,0,-39
3486,1,1,236,1492,1256
3487,0,0,75,0,-75
3488,0,0,62,0,-62
3489,1,0,60,0,-60
3490,1,0,16,0,-16
3491,0,0,20,0,-20
3492,1,1,440,1233,793
3493,0,0,1,0,-1
3494,1,0,0,0,0
3495,1,0,3,0,-3
3496,1,0,23,0,-23
3497,1,0,10,0,-10
3498,1,0,4,0,-4
3499,0,0,48,0,-48
3500,1,0,103,0,-103
3501,1,1,58,1294,1236
3502,1,1,117,1283,1166
3503,1,1,46,1321,1275
3504,0,0,244,0,-244
3505,1,0,11,0,-11
3506,1,1,204,1878,1674
3507,1,1,481,1483,1002
3508,1,0,23,0,-23
3509,1,0,16,0,-16
3510,1,1,555,1526,971
3511,1,0,70,0,-70
3512,1,1,685,1233,548
3513,1,1,2692,1267,-1425
3514,0,0,6,0,-6
3515,0,0,78,0,-78
3516,1,1,496,1774,1278
3517,0,0,50,0,-50
3518,1,0,12,0,-12
3519,0,0,18,0,-18
3520,0,0,2,0,-2
3521,1,0,29,0,-29
3522,1,0,116,0,-116
3523,1,0,114,0,-114
3524,0,0,9,0,-9
3525,0,0,6,0,-6
3526,1,0,22,0,-22
3527,1,0,58,0,-58
3528,1,0,92,0,-92
3529,1,1,276,2131,1855
3530,0,0,33,0,-33
3531,0,0,195,0,-195
3532,0,0,80,0,-80
3533,0,0,5,0,-5
3534,1,1,510,1257,747
3535,1,0,11,0,-11
3536,0,0,13,0,-13
3537,1,0,30,0,-30
3538,0,0,13,0,-13
3539,0,0,1,0,-1
3540,1,1,590,1495,905
3541,1,1,942,1333,391
3542,0,0,98,0,-98
3543,0,0,75,0,-75
3544,0,0,180,0,-180
3545,1,0,123,0,-123
3546,0,0,3,0,-3
3547,0,0,67,0,-67
3548,0,0,9,0,-9
3549,0,0,73,0,-73
3550,1,0,135,0,-135
3551,0,0,44,0,-44
3552,0,0,218,0,-218
3553,1,1,505,1499,994
3554,0,0,17,0,-17
3555,1,0,0,0,0
3556,0,0,87,0,-87
3557,0,0,79,0,-79
3558,1,1,559,2522,1963
3559,1,0,77,0,-77
3560,1,1,1247,1420,173
3561,0,0,114,0,-114
3562,1,0,27,0,-27
3563,1,0,102,0,-102
3564,1,0,38,0,-38
3565,1,0,0,0,0
3566,0,0,42,0,-42
3567,1,1,60,1243,1183
3568,0,0,36,0,-36
3569,1,1,436,1784,1348
3570,1,0,25,0,-25
3571,0,0,3,0,-3
3572,1,0,11,0,-11
3573,1,1,475,1218,743
3574,1,0,6,0,-6
3575,0,0,143,0,-143
3576,1,1,186,1328,1142
3577,0,0,57,0,-57
3578,0,0,81,0,-81
3579,1,0,65,0,-65
3580,1,1,352,2284,1932
3581,0,0,117,0,-117
3582,1,0,14,0,-14
3583,1,1,429,1401,972
3584,0,0,5,0,-5
3585,0,0,17,0,-17
3586,0,0,26,0,-26
3587,0,0,46,0,-46
3588,1,1,301,1245,944
3589,1,1,1246,1267,21
3590,0,0,87,0,-87
3591,0,0,7,0,-7
3592,1,0,95,0,-95
3593,1,0,32,0,-32
3594,0,0,35,0,-35
3595,1,0,24,0,-24
3596,1,0,11,0,-11
3597,0,0,52,0,-52
3598,1,0,68,0,-68
3599,0,0,10,0,-10
3600,0,0,55,0,-55
3601,1,0,66,0,-66
3602,1,1,128,1484,1356
3603,1,1,510,1208,698
3604,1,0,76,0,-76
3605,0,0,17,0,-17
3606,1,0,37,0,-37
3607,1,0,86,0,-86
3608,1,0,34,0,-34
3609,1,1,503,1274,771
3610,0,0,254,0,-254
3611,0,0,98,0,-98
3612,1,0,44,0,-44
3613,1,1,584,1222,638
3614,0,0,48,0,-48
3615,0,0,69,0,-69
3616,0,0,4,0,-4
3617,0,0,11,0,-11
3618,0,0,66,0,-66
3619,1,1,279,2889,2610
3620,1,0,5,0,-5
3621,1,0,67,0,-67
3622,1,0,90,0,-90
3623,1,0,3,0,-3
3624,0,0,6,0,-6
3625,0,0,0,0,0
3626,0,0,4,0,-4
3627,1,1,281,1603,1322
3628,1,0,4,0,-4
3629,0,0,64,0,-64
3630,0,0,27,0,-27
3631,1,0,3,0,-3
3632,0,0,25,0,-25
3633,1,0,12,0,-12
3634,1,0,73,0,-73
3635,1,0,104,0,-104
3636,1,1,82,2400,2318
3637,1,0,2,0,-2
3638,0,0,16,0,-16
3639,1,1,467,1243,776
3640,0,0,136,0,-136
3641,1,1,126,1234,1108
3642,1,0,81,0,-81
3643,1,0,41,0,-41
3644,1,0,4,0,-4
3645,1,0,31,0,-31
3646,1,0,109,0,-109
3647,1,1,422,1340,918
3648,1,1,462,1275,813
3649,1,1,231,2139,1908
3650,0,0,112,0,-112
3651,1,1,153,1302,1149
3652,1,1,46,1546,1500
3653,1,0,0,0,0
3654,0,0,62,0,-62
3655,1,1,90,1641,1551
3656,1,1,2108,1912,-196
3657,1,0,36,0,-36
3658,1,0,44,0,-44
3659,1,1,105,1202,1097
3660,0,0,66,0,-66
3661,1,1,1390,1404,14
3662,1,0,15,0,-15
3663,0,0,22,0,-22
3664,1,1,459,1702,1243
3665,0,0,3,0,-3
3666,1,0,64,0,-64
3667,1,1,24,1261,1237
3668,0,0,22,0,-22
3669,1,1,271,1344,1073
3670,0,0,8,0,-8
3671,1,1,1137,1392,255
3672,1,1,306,1899,1593
3673,1,0,151,0,-151
3674,0,0,45,0,-45
3675,1,1,790,2176,1386
3676,0,0,23,0,-23
3677,0,0,9,0,-9
3678,0,0,45,0,-45
3679,1,0,81,0,-81
3680,0,0,8,0,-8
3681,1,0,35,0,-35
3682,1,0,2,0,-2
3683,0,0,54,0,-54
3684,1,1,44,1281,1237
3685,1,0,58,0,-58
3686,0,0,28,0,-28
3687,0,0,3,0,-3
3688,1,1,584,1375,791
3689,1,0,64,0,-64
3690,1,0,89,0,-89
3691,1,1,791,1208,417
3692,0,0,30,0,-30
3693,1,0,65,0,-65
3694,1,0,17,0,-17
3695,0,0,135,0,-135
3696,0,0,4,0,-4
3697,0,0,61,0,-61
3698,1,0,68,0,-68
3699,1,0,100,0,-100
3700,0,0,44,0,-44
3701,1,0,8,0,-8
3702,0,0,25,0,-25
3703,1,1,965,1515,550
3704,1,0,36,0,-36
3705,0,0,1,0,-1
3706,0,0,7,0,-7
3707,0,0,51,0,-51
3708,1,0,94,0,-94
3709,1,0,132,0,-132
3710,1,0,34,0,-34
3711,1,1,61,1511,1450
3712,0,0,205,0,-205
3713,1,1,981,1569,588
3714,0,0,155,0,-155
3715,1,1,80,1225,1145
3716,1,0,32,0,-32
3717,0,0,4,0,-4
3718,1,1,392,1423,1031
3719,1,0,25,0,-25
3720,1,1,62,1297,1235
3721,0,0,20,0,-20
3722,0,0,40,0,-40
3723,1,0,18,0,-18
3724,1,0,8,0,-8
3725,1,1,1065,1326,261
3726,1,1,233,1253,1020
3727,0,0,68,0,-68
3728,1,0,22,0,-22
3729,1,1,191,1380,1189
3730,1,0,23,0,-23
3731,1,1,1825,1203,-622
3732,1,0,62,0,-62
3733,1,1,709,1323,614
3734,1,0,23,0,-23
3735,1,0,13,0,-13
3736,0,0,62,0,-62
3737,0,0,85,0,-85
3738,1,1,135,1603,1468
3739,0,0,5,0,-5
3740,1,0,5,0,-5
3741,1,0,34,0,-34
3742,1,0,59,0,-59
3743,1,0,84,0,-84
3744,1,1,341,1424,1083
3745,0,0,51,0,-51
3746,0,0,41,0,-41
3747,1,0,49,0,-49
3748,1,1,530,1511,981
3749,0,0,39,0,-39
3750,0,0,46,0,-46
3751,1,1,163,1569,1406
3752,1,0,19,0,-19
3753,0,0,36,0,-36
3754,1,1,221,1352,1131
3755,0,0,6,0,-6
3756,1,0,11,0,-11
3757,0,0,143,0,-143
3758,1,0,67,0,-67
3759,1,1,1022,1366,344
3760,1,0,17,0,-17
3761,0,0,158,0,-158
3762,1,0,33,0,-33
3763,0,0,108,0,-108
3764,1,1,247,1209,962
3765,1,1,81,1297,1216
3766,1,0,11,0,-11
3767,1,1,349,1417,1068
3768,0,0,8,0,-8
3769,0,0,31,0,-31
3770,1,0,109,0,-109
3771,1,0,16,0,-16
3772,1,0,118,0,-118
3773,1,0,2,0,-2
3774,0,0,82,0,-82
3775,0,0,14,0,-14
3776,1,0,55,0,-55
3777,1,1,225,4046,3821
3778,0,0,1,0,-1
3779,1,0,13,0,-13
3780,0,0,13,0,-13
3781,1,1,1472,1399,-73
3782,0,0,70,0,-70
3783,1,1,280,1852,1572
3784,0,0,46,0,-46
3785,1,1,481,1422,941
3786,0,0,5,0,-5
3787,1,1,72,2176,2104
3788,0,0,0,0,0
3789,0,0,62,0,-62
3790,1,1,708,1315,607
3791,1,1,185,1676,1491
3792,1,0,46,0,-46
3793,0,0,93,0,-93
3794,0,0,43,0,-43
3795,1,0,11,0,-11
3796,0,0,27,0,-27
3797,1,1,2196,3694,1498
3798,1,1,433,1739,1306
3799,1,1,104,1231,1127
3800,1,1,70,2301,2231
3801,0,0,55,0,-55
3802,1,1,854,1202,348
3803,1,0,47,0,-47
3804,1,1,337,1401,1064
3805,1,1,339,1492,1153
3806,1,0,11,0,-11
3807,1,1,435,1358,923
3808,1,0,39,0,-39
3809,1,0,39,0,-39
3810,1,0,30,0,-30
3811,1,1,1113,1448,335
3812,1,0,57,0,-57
3813,0,0,18,0,-18
3814,1,1,1004,1501,497
3815,1,0,24,0,-24
3816,1,1,110,2542,2432
3817,1,0,44,0,-44
3818,1,1,88,1819,1731
3819,1,0,38,0,-38
3820,0,0,151,0,-151
3821,0,0,1,0,-1
3822,1,1,1352,1340,-12
3823,1,0,21,0,-21
3824,1,1,1081,1481,400
3825,1,1,799,1265,466
3826,1,1,274,1332,1058
3827,0,0,82,0,-82
3828,1,0,65,0,-65
3829,1,0,7,0,-7
3830,1,1,192,2833,2641
3831,0,0,2,0,-2
3832,0,0,194,0,-194
3833,0,0,31,0,-31
3834,1,0,81,0,-81
3835,1,1,161,1408,1247
3836,1,0,129,0,-129
3837,1,1,374,1458,1084
3838,1,1,764,1570,806
3839,1,0,6,0,-6
3840,1,0,114,0,-114
3841,0,0,45,0,-45
3842,1,1,552,1306,754
3843,1,1,1122,1567,445
3844,1,1,1391,1751,360
3845,1,0,2,0,-2
3846,1,1,281,1864,1583
3847,0,0,16,0,-16
3848,1,1,212,2757,2545
3849,1,0,6,0,-6
3850,1,1,662,1285,623
3851,1,1,705,1262,557
3852,0,0,27,0,-27
3853,0,0,55,0,-55
3854,1,0,34,0,-34
3855,0,0,48,0,-48
3856,0,0,2,0,-2
3857,0,0,56,0,-56
3858,1,0,15,0,-15
3859,0,0,71,0,-71
3860,0,0,4,0,-4
3861,1,1,1033,1374,341
3862,1,1,1002,1446,444
3863,1,1,7,1731,1724
3864,1,1,1042,1361,319
3865,1,0,27,0,-27
3866,0,0,73,0,-73
3867,0,0,53,0,-53
3868,0,0,1,0,-1
3869,1,0,2,0,-2
3870,1,0,59,0,-59
3871,0,0,38,0,-38
3872,1,1,552,1832,1280
3873,0,0,20,0,-20
3874,0,0,13,0,-13
3875,0,0,42,0,-42
3876,0,0,9,0,-9
3877,1,0,221,0,-221
3878,0,0,40,0,-40
3879,0,0,3,0,-3
3880,0,0,31,0,-31
3881,0,0,6,0,-6
3882,1,0,31,0,-31
3883,1,1,105,2039,1934
3884,1,1,239,1706,1467
3885,1,0,27,0,-27
3886,0,0,4,0,-4
3887,1,1,1307,1992,685
3888,1,0,6,0,-6
3889,1,0,64,0,-64
3890,1,0,183,0,-183
3891,0,0,40,0,-40
3892,1,1,1088,1209,121
3893,1,1,191,2325,2134
3894,0,0,9,0,-9
3895,0,0,9,0,-9
3896,0,0,25,0,-25
3897,1,0,40,0,-40
3898,1,0,56,0,-56
3899,0,0,22,0,-22
3900,1,1,321,1334,1013
3901,1,1,455,1249,794
3902,1,1,561,1551,990
3903,1,1,548,1489,941
3904,0,0,32,0,-32
3905,0,0,26,0,-26
3906,0,0,15,0,-15
3907,1,1,527,2471,1944
3908,1,1,247,2572,2325
3909,1,0,51,0,-51
3910,0,0,43,0,-43
3911,0,0,15,0,-15
3912,1,1,64,1216,1152
3913,0,0,8,0,-8
3914,1,1,349,1918,1569
3915,0,0,7,0,-7
3916,1,0,179,0,-179
3917,0,0,15,0,-15
3918,0,0,19,0,-19
3919,0,0,12,0,-12
3920,1,1,178,1244,1066
3921,1,1,1573,1444,-129
3922,0,0,3,0,-3
3923,1,1,680,1306,626
3924,0,0,73,0,-73
3925,1,0,10,0,-10
3926,0,0,61,0,-61
3927,1,0,13,0,-13
3928,1,0,61,0,-61
3929,0,0,12,0,-12
3930,1,1,691,1458,767
3931,0,0,0,0,0
3932,0,0,15,0,-15
3933,1,0,40,0,-40
3934,1,0,24,0,-24
3935,0,0,89,0,-89
3936,1,1,1607,1771,164
3937,1,0,20,0,-20
3938,1,0,29,0,-29
3939,0,0,101,0,-101
3940,1,0,61,0,-61
3941,1,1,105,1455,1350
3942,1,0,2,0,-2
3943,0,0,35,0,-35
3944,1,0,1,0,-1
3945,1,1,18,1534,1516
3946,0,0,124,0,-124
3947,0,0,90,0,-90
3948,1,1,394,1651,1257
3949,0,0,34,0,-34
3950,1,1,213,1278,1065
3951,0,0,34,0,-34
3952,1,0,83,0,-83
3953,0,0,97,0,-97
3954,1,0,47,0,-47
3955,0,0,0,0,0
3956,1,0,155,0,-155
3957,0,0,33,0,-33
3958,0,0,64,0,-64
3959,0,0,22,0,-22
3960,1,1,280,1770,1490
3961,1,1,775,2338,1563
3962,1,0,68,0,-68
3963,0,0,25,0,-25
3964,0,0,64,0,-64
3965,1,0,0,0,0
3966,0,0,53,0,-53
3967,0,0,2,0,-2
3968,1,1,186,1578,1392
3969,1,1,495,1536,1041
3970,1,0,185,0,-185
3971,0,0,58,0,-58
3972,0,0,77,0,-77
3973,1,0,128,0,-128
3974,1,1,412,1944,1532
3975,0,0,4,0,-4
3976,0,0,117,0,-117
3977,0,0,10,0,-10
3978,1,1,431,1880,1449
3979,1,1,611,1328,717
3980,1,0,38,0,-38
3981,0,0,5,0,-5
3982,0,0,16,0,-16
3983,0,0,9,0,-9
3984,0,0,73,0,-73
3985,1,1,515,1552,1037
3986,1,1,1443,2137,694
3987,0,0,19,0,-19
3988,0,0,27,0,-27
3989,1,0,22,0,-22
3990,0,0,29,0,-29
3991,1,0,29,0,-29
3992,1,1,189,2255,2066
3993,1,1,105,1344,1239
3994,1,1,923,1356,433
3995,0,0,0,0,0
3996,1,0,7,0,-7
3997,0,0,97,0,-97
3998,1,1,43,1570,1527
3999,1,1,175,1205,1030
4000,1,0,29,0,-29
4001,0,0,120,0,-120
4002,0,0,23,0,-23
4003,1,1,190,2655,2465
4004,1,0,59,0,-59
4005,1,1,534,1634,1100
4006,0,0,13,0,-13
4007,1,0,79,0,-79
4008,1,0,14,0,-14
4009,1,1,39,1320,1281
4010,0,0,95,0,-95
4011,0,0,10,0,-10
4012,1,0,2,0,-2
4013,0,0,143,0,-143
4014,0,0,82,0,-82
4015,1,0,18,0,-18
4016,1,0,37,0,-37
4017,1,0,73,0,-73
4018,0,0,85,0,-85
4019,0,0,54,0,-54
4020,1,1,1299,1244,-55
4021,1,0,29,0,-29
4022,1,1,378,2120,1742
4023,1,1,282,1242,960
4024,1,0,105,0,-105
4025,0,0,279,0,-279
4026,0,0,21,0,-21
4027,0,0,14,0,-14
4028,1,0,10,0,-10
4029,1,1,100,1590,1490
4030,1,1,737,1481,744
4031,1,1,2536,1250,-1286
4032,0,0,3,0,-3
4033,0,0,20,0,-20
4034,0,0,115,0,-115
4035,0,0,32,0,-32
4036,0,0,135,0,-135
4037,0,0,52,0,-52
4038,1,0,28,0,-28
4039,0,0,235,0,-235
4040,0,0,39,0,-39
4041,0,0,41,0,-41
4042,1,0,63,0,-63
4043,1,0,103,0,-103
4044,0,0,2,0,-2
4045,1,1,510,1260,750
4046,1,0,90,0,-90
4047,0,0,94,0,-94
4048,1,0,54,0,-54
4049,0,0,5,0,-5
4050,1,0,29,0,-29
4051,0,0,37,0,-37
4052,1,0,20,0,-20
4053,0,0,101,0,-101
4054,0,0,0,0,0
4055,0,0,40,0,-40
4056,1,1,555,1777,1222
4057,1,1,914,1508,594
4058,0,0,5,0,-5
4059,1,0,6,0,-6
4060,1,1,372,1413,1041
4061,1,1,47,1394,1347
4062,1,1,130,1309,1179
4063,1,0,34,0,-34
4064,0,0,68,0,-68
4065,0,0,78,0,-78
4066,1,1,946,1469,523
4067,1,1,169,1209,1040
4068,0,0,28,0,-28
4069,0,0,5,0,-5
4070,1,0,25,0,-25
4071,0,0,28,0,-28
4072,0,0,56,0,-56
4073,1,0,4,0,-4
4074,1,1,492,1225,733
4075,1,0,27,0,-27
4076,1,0,121,0,-121
4077,1,1,176,1632,1456
4078,1,0,23,0,-23
4079,1,0,50,0,-50
4080,1,0,1,0,-1
4081,0,0,22,0,-22
4082,1,0,19,0,-19
4083,1,0,78,0,-78
4084,0,0,70,0,-70
4085,1,1,520,2715,2195
4086,0,0,125,0,-125
4087,1,0,79,0,-79
4088,1,1,94,1635,1541
4089,1,1,222,1292,1070
4090,1,1,322,1313,991
4091,1,0,90,0,-90
4092,1,1,76,1311,1235
4093,1,1,432,1776,1344
4094,1,0,14,0,-14
4095,0,0,20,0,-20
4096,1,1,549,1400,851
4097,1,1,319,1379,1060
4098,1,1,287,1842,1555
4099,0,0,22,0,-22
4100,1,0,22,0,-22
4101,0,0,81,0,-81
4102,1,1,50,1347,1297
4103,1,0,18,0,-18
4104,1,1,790,1275,485
4105,1,0,1,0,-1
4106,0,0,52,0,-52
4107,1,0,15,0,-15
4108,1,1,587,1225,638
4109,0,0,75,0,-75
4110,1,0,45,0,-45
4111,1,0,6,0,-6
4112,0,0,65,0,-65
4113,1,0,21,0,-21
4114,1,0,79,0,-79
4115,0,0,41,0,-41
4116,0,0,6,0,-6
4117,0,0,42,0,-42
4118,1,0,15,0,-15
4119,1,1,23,1202,1179
4120,0,0,61,0,-61
4121,1,0,11,0,-11
4122,0,0,68,0,-68
4123,0,0,51,0,-51
4124,1,1,78,1799,1721
4125,1,0,9,0,-9
4126,1,0,4,0,-4
4127,0,0,10,0,-10
4128,0,0,244,0,-244
4129,1,0,38,0,-38
4130,1,1,458,1978,1520
4131,1,1,1628,1204,-424
4132,0,0,50,0,-50
4133,0,0,49,0,-49
4134,1,0,2,0,-2
4135,1,1,916,1253,337
4136,1,0,29,0,-29
4137,0,0,78,0,-78
4138,1,1,672,1257,585
4139,0,0,43,0,-43
4140,1,0,90,0,-90
4141,1,1,735,3302,2567
4142,1,0,1,0,-1
4143,0,0,61,0,-61
4144,1,0,29,0,-29
4145,0,0,5,0,-5
4146,0,0,31,0,-31
4147,0,0,46,0,-46
4148,1,1,473,1975,1502
4149,1,0,37,0,-37
4150,1,0,61,0,-61
4151,1,1,868,1269,401
4152,0,0,37,0,-37
4153,0,0,93,0,-93
4154,1,1,299,1619,1320
4155,0,0,41,0,-41
4156,1,1,112,1206,1094
4157,0,0,94,0,-94
4158,1,0,22,0,-22
4159,1,1,1739,1912,173
4160,0,0,23,0,-23
4161,1,0,5,0,-5
4162,0,0,8,0,-8
4163,1,1,738,1581,843
4164,0,0,13,0,-13
4165,1,1,770,1243,473
4166,1,1,384,1389,1005
4167,0,0,12,0,-12
4168,1,0,49,0,-49
4169,1,1,1498,1556,58
4170,1,0,1,0,-1
4171,1,1,388,1931,1543
4172,1,1,488,2694,2206
4173,1,1,674,2007,1333
4174,1,0,174,0,-174
4175,0,0,29,0,-29
4176,0,0,8,0,-8
4177,1,1,133,1302,1169
4178,0,0,0,0,0
4179,0,0,26,0,-26
4180,0,0,6,0,-6
4181,0,0,51,0,-51
4182,0,0,27,0,-27
4183,0,0,24,0,-24
4184,0,0,19,0,-19
4185,1,0,113,0,-113
4186,0,0,4,0,-4
4187,1,0,42,0,-42
4188,1,0,2,0,-2
4189,1,0,5,0,-5
4190,0,0,2,0,-2
4191,1,0,8,0,-8
4192,0,0,11,0,-11
4193,0,0,90,0,-90
4194,1,0,102,0,-102
4195,1,0,137,0,-137
4196,0,0,23,0,-23
4197,1,1,428,1551,1123
4198,0,0,74,0,-74
4199,0,0,40,0,-40
4200,1,0,41,0,-41
4201,0,0,0,0,0
4202,1,1,737,1593,856
4203,1,1,172,1296,1124
4204,0,0,131,0,-131
4205,1,0,29,0,-29
4206,1,0,8,0,-8
4207,1,0,0,0,0
4208,1,0,8,0,-8
4209,0,0,87,0,-87
4210,0,0,86,0,-86
4211,0,0,149,0,-149
4212,0,0,4,0,-4
4213,0,0,6,0,-6
4214,1,0,127,0,-127
4215,1,1,1100,1446,346
4216,0,0,49,0,-49
4217,1,0,43,0,-43
4218,0,0,14,0,-14
4219,1,1,867,1269,402
4220,0,0,28,0,-28
4221,0,0,27,0,-27
4222,0,0,101,0,-101
4223,1,0,88,0,-88
4224,1,1,342,1214,872
4225,0,0,53,0,-53
4226,1,0,11,0,-11
4227,1,1,956,1611,655
4228,1,1,333,1621,1288
4229,1,0,156,0,-156
4230,1,0,3,0,-3
4231,0,0,63,0,-63
4232,1,1,369,1458,1089
4233,1,0,5,0,-5
4234,1,0,53,0,-53
4235,1,1,241,1236,995
4236,1,0,33,0,-33
4237,0,0,33,0,-33
4238,0,0,4,0,-4
4239,1,1,243,1287,1044
4240,1,0,68,0,-68
4241,1,0,14,0,-14
4242,0,0,13,0,-13
4243,1,0,99,0,-99
4244,1,0,5,0,-5
4245,1,1,198,1289,1091
4246,1,0,3,0,-3
4247,0,0,55,0,-55
4248,0,0,6,0,-6
4249,1,1,661,1225,564
4250,0,0,49,0,-49
4251,0,0,27,0,-27
4252,1,0,66,0,-66
4253,1,1,1092,1271,179
4254,1,1,1430,1284,-146
4255,1,0,1,0,-1
4256,1,1,1030,1209,179
4257,1,0,9,0,-9
4258,1,1,774,1376,602
4259,0,0,34,0,-34
4260,1,1,483,2272,1789
4261,1,1,100,2002,1902
4262,0,0,70,0,-70
4263,1,1,508,1229,721
4264,1,0,56,0,-56
4265,1,0,17,0,-17
4266,1,1,460,1522,1062
4267,0,0,51,0,-51
4268,0,0,17,0,-17
4269,0,0,17,0,-17
4270,0,0,140,0,-140
4271,1,0,1,0,-1
4272,1,0,69,0,-69
4273,1,0,79,0,-79
4274,1,0,76,0,-76
4275,1,0,11,0,-11
4276,0,0,14,0,-14
4277,0,0,299,0,-299
4278,1,0,65,0,-65
4279,0,0,20,0,-20
4280,1,0,46,0,-46
4281,0,0,8,0,-8
4282,1,1,135,1237,1102
4283,0,0,158,0,-158
4284,0,0,70,0,-70
4285,1,1,843,1276,433
4286,0,0,128,0,-128
4287,1,0,23,0,-23
4288,1,0,153,0,-153
4289,1,0,16,0,-16
4290,0,0,34,0,-34
4291,1,1,131,1460,1329
4292,1,1,839,1874,1035
4293,1,0,0,0,0
4294,1,0,66,0,-66
4295,1,0,73,0,-73
4296,0,0,11,0,-11
4297,1,1,516,1233,717
4298,0,0,9,0,-9
4299,1,0,16,0,-16
4300,0,0,41,0,-41
4301,1,0,153,0,-153
4302,0,0,16,0,-16
4303,0,0,93,0,-93
4304,1,0,4,0,-4
4305,1,1,530,1558,1028
4306,1,0,19,0,-19
4307,0,0,8,0,-8
4308,1,0,26,0,-26
4309,0,0,119,0,-119
4310,1,1,76,1240,1164
4311,1,0,0,0,0
4312,1,1,543,1255,712
4313,1,0,122,0,-122
4314,1,0,1,0,-1
4315,1,1,254,1246,992
4316,1,0,12,0,-12
4317,0,0,9,0,-9
4318,0,0,31,0,-31
4319,1,0,133,0,-133
4320,1,0,91,0,-91
4321,1,0,3,0,-3
4322,1,1,128,1348,1220
4323,0,0,66,0,-66
4324,1,0,143,0,-143
4325,1,0,10,0,-10
4326,1,0,9,0,-9
4327,0,0,13,0,-13
4328,1,0,36,0,-36
4329,1,0,66,0,-66
4330,0,0,48,0,-48
4331,1,0,98,0,-98
4332,1,1,954,1614,660
4333,1,0,9,0,-9
4334,1,1,62,1238,1176
4335,1,1,677,1285,608
4336,1,1,1392,1333,-59
4337,1,0,43,0,-43
4338,0,0,96,0,-96
4339,1,1,421,1600,1179
4340,1,1,100,1442,1342
4341,1,1,597,1497,900
4342,1,1,895,1596,701
4343,1,0,5,0,-5
4344,1,0,36,0,-36
4345,1,0,26,0,-26
4346,1,0,22,0,-22
4347,1,1,554,2788,2234
4348,1,1,245,2785,2540
4349,1,0,73,0,-73
4350,1,0,70,0,-70
4351,1,0,41,0,-41
4352,1,1,43,1603,1560
4353,1,0,11,0,-11
4354,1,0,32,0,-32
4355,0,0,212,0,-212
4356,1,0,69,0,-69
4357,1,1,295,1760,1465
4358,1,1,164,1532,1368
4359,1,1,275,1453,1178
4360,0,0,22,0,-22
4361,1,0,32,0,-32
4362,0,0,11,0,-11
4363,0,0,15,0,-15
4364,0,0,4,0,-4
4365,1,0,24,0,-24
4366,0,0,99,0,-99
4367,1,1,190,1271,1081
4368,0,0,10,0,-10
4369,1,1,544,1793,1249
4370,1,1,482,1292,810
4371,0,0,14,0,-14
4372,0,0,1,0,-1
4373,1,1,628,1277,649
4374,0,0,22,0,-22
4375,0,0,33,0,-33
4376,0,0,73,0,-73
4377,1,1,503,1559,1056
4378,0,0,73,0,-73
4379,0,0,56,0,-56
4380,1,0,52,0,-52
4381,1,1,340,1319,979
4382,0,0,18,0,-18
4383,1,0,15,0,-15
4384,0,0,18,0,-18
4385,0,0,22,0,-22
4386,0,0,68,0,-68
4387,1,1,192,1208,1016
4388,0,0,105,0,-105
4389,1,0,125,0,-125
4390,1,0,32,0,-32
4391,1,1,773,1529,756
4392,0,0,16,0,-16
4393,1,1,344,1704,1360
4394,0,0,152,0,-152
4395,0,0,10,0,-10
4396,1,1,765,1257,492
4397,1,1,62,2182,2120
4398,1,1,247,1252,1005
4399,0,0,34,0,-34
4400,0,0,42,0,-42
4401,0,0,76,0,-76
4402,1,0,12,0,-12
4403,1,0,3,0,-3
4404,0,0,2,0,-2
4405,1,1,210,2221,2011
4406,1,0,44,0,-44
4407,1,0,60,0,-60
4408,0,0,0,0,0
4409,0,0,15,0,-15
4410,1,1,347,1337,990
4411,0,0,54,0,-54
4412,1,1,594,1926,1332
4413,1,1,94,1455,1361
4414,1,0,173,0,-173
4415,1,0,24,0,-24
4416,1,0,15,0,-15
4417,0,0,120,0,-120
4418,0,0,22,0,-22
4419,1,0,22,0,-22
4420,0,0,25,0,-25
4421,1,1,314,1314,1000
4422,1,1,1011,2698,1687
4423,0,0,12,0,-12
4424,1,0,280,0,-280
4425,0,0,86,0,-86
4426,0,0,0,0,0
4427,1,1,199,1333,1134
4428,1,0,78,0,-78
4429,1,1,1335,1297,-38
4430,1,1,286,1479,1193
4431,1,0,3,0,-3
4432,1,0,123,0,-123
4433,0,0,26,0,-26
4434,1,1,566,1257,691
4435,0,0,51,0,-51
4436,1,0,79,0,-79
4437,1,0,5,0,-5
4438,1,1,365,1934,1569
4439,1,0,79,0,-79
4440,0,0,60,0,-60
4441,1,0,49,0,-49
4442,1,0,1,0,-1
4443,0,0,6,0,-6
4444,1,1,174,1241,1067
4445,0,0,4,0,-4
4446,0,0,126,0,-126
4447,0,0,41,0,-41
4448,0,0,125,0,-125
4449,1,0,20,0,-20
4450,1,1,251,1787,1536
4451,1,0,13,0,-13
4452,1,0,66,0,-66
4453,1,1,86,1299,1213
4454,1,1,1867,1621,-246
4455,1,0,39,0,-39
4456,1,0,38,0,-38
4457,1,0,194,0,-194
4458,0,0,1,0,-1
4459,0,0,44,0,-44
4460,0,0,45,0,-45
4461,1,0,63,0,-63
